  58  58  58  58  58  58  10   1  34  34  34   7   7   7   7   8   9  21  21  22  28  28  28  28  28  28  28  28  57  57  57  57  57  57  57  57  57 173 173 173 173 138 138 138 138 138 138 138 138 274 274 274 274 274 274 274 274 274 274 274 274 274 274 274 274 274 274 274 274 274 274 274 274 274 274 274 274 274 274 274 274 274 274 274 274 274 274 274 274 274
  58  58  58  58  58  58  10   1   2   3  34   4   5   6   7   8   9  21  21  22  23  24  25  49  49  49  28  28  57  57  57  57  57  57  57  57  57  57 173 173 173 138 138 138 138 138 138 138 138 274 274 274 274 274 274 274 274 274 274 274 274 274 274 274 274 274 274 274 274 274 274 274 274 274 274 274 274 274 274 274 274 274 274 274 274 274 274 274 274 274
  58  58  58  58  58  58  10  11  12  13  34  14  15  16  17  18  19  20  21  22  23  24  25  26  27  49  50  28  57  57  57  57  57  57  57  57  57  57 173 173 173 138 138 138 138 138 138 274 274 274 274 274 274 274 274 274 274 274 274 274 274 274 274 274 274 274 274 274 274 274 274 274 274 274 274 274 274 274 274 274 274 274 274 274 274 274 274 274 274 274
 100  58  58  58  58  29  30  31  32  33  34  35  36  37  38  39  40  41  42  43  44  45  46  47  48  49  50  51  52  53  54  55  56  57  57  57  57  57 173 173 173 138 138 138 138 138 138 274 274 274 274 274 274 274 274 274 274 274 274 274 274 274 274 274 274 274 274 274 274 274 274 274 274 274 274 274 274 274 274 274 274 274 274 274 274 274 274 274 274 274
 100 100  58  58  58  58  59  60  61  62  63  64  65  66  67  68  69  70  71  72  73  74  75  76  77  78 154  79  99  99  80 136 136 136  57  57  57  57 118 118 173 138 138 138 138 138 138 274 274 274 274 274 274 274 274 274 274 274 274 274 274 274 274 274 274 274 274 274 274 274 274 274 274 274 274 274 274 274 274 274 274 274 274 274 274 274 274 274 274 274
 100 100 100 100 100  58  58  81  82  83  84  85  86  87  88  89  90  91  92  93  94  95  96  97  78  78 154  98  99  99 136 136 136 136  57  57  57 118 118 118 173 138 138 138 138 138 138 274 274 274 274 274 274 274 274 274 274 274 274 274 274 274 274 274 274 274 274 274 274 274 274 274 274 274 274 274 274 274 274 274 274 274 274 274 274 274 274 274 274 274
 100 100 100 100 100 100 100 101 101 102 103 104 105 106 107 108 109 110 111 112 113 114 115 116 117  78 154  99  99  99 136 136 136 136 137 137 118 118 118 118 173 173 173 138 138 138 274 274 274 274 274 274 274 274 274 274 274 274 274 274 274 274 274 274 274 274 274 274 274 274 274 274 274 274 274 274 274 274 274 274 274 274 274 274 274 274 274 274 274 274
 100 100 283 283 283 283 100 119 283 120 121 122 123 124 125 126 127 128 129 130 131 132 133 134 135 154 154  99  99  99 136 136 136 136 137 137 173 173 173 173 173 173 138 138 138 138 274 274 274 274 274 274 274 274 274 274 274 274 274 274 274 274 274 274 274 274 274 274 274 274 274 274 274 274 274 274 274 274 274 274 274 274 274 274 274 274 274 274 274 274
 100 100 100 283 283 283 283 283 283 139 140 141 142 143 144 145 146 147 148 149 150 151 167 152 169 153 154  99  99  99 136 172 172 137 137 137 207 207 207 173 173 173 138 138 138 138 274 274 274 274 274 274 274 274 274 274 274 274 274 274 274 274 274 274 274 274 274 274 274 274 274 274 274 274 274 274 274 274 274 274 274 274 274 274 274 274 274 274 274 274
 100 100 100 283 283 283 283 283 174 174 155 156 157 158 159 160 161 162 163 164 165 166 167 168 169 170 171  99  99  99 172 172 172 137 137 207 207 207 207 173 173 173 138 138 138 138 274 274 274 274 274 274 274 274 274 274 274 274 274 274 274 274 274 274 274 274 274 274 274 274 274 274 274 274 274 274 274 274 274 274 274 274 274 274 274 274 274 274 274 274
 100 100 100 283 283 283 283 283 174 174 175 176 177 178 179 180 181 182 183 184 185 186 167 187 188 189 171 190  99  99 172 172 137 137 207 207 207 207 173 173 173 173 138 138 138 138 274 274 274 274 274 274 274 274 274 274 274 274 274 274 274 274 274 274 274 274 274 274 274 274 274 274 274 274 274 274 274 274 274 274 274 274 274 274 274 274 274 274 274 274
 100 100 283 283 283 283 283 283 174 174 253 176 191 192 193 194 195 196 196 197 198 199 200 201 202 203 204 205 206 225 137 137 137 137 226 207 207 207 207 173 173 173 138 138 138 138 274 274 274 274 274 274 274 274 274 274 274 274 274 274 274 274 274 274 274 274 274 274 274 274 274 274 274 274 274 274 274 274 274 274 274 274 274 274 274 274 274 274 274 274
 100 100 100 283 283 283 283 283 283 283 253 208 209 210 211 212 213 214 215 216 217 218 219 220 221 222 223 224 261 225 269 269 226 226 226 207 207 207 207 173 173 173 278 278 138 274 274 274 274 274 274 274 274 274 274 274 274 274 274 274 274 274 274 274 274 274 274 274 274 274 274 274 274 274 274 274 274 274 274 274 274 274 274 274 274 274 274 274 274 274
 100 100 100 100 283 283 283 283 283 283 253 209 209 227 211 228 229 214 230 231 232 233 234 235 236 237 238 224 261 225 269 269 226 226 226 207 207 207 207 173 173 173 278 278 278 274 274 274 274 274 274 274 274 274 274 274 274 274 274 274 274 274 274 274 274 274 274 274 274 274 274 274 274 274 274 274 274 274 274 274 274 274 274 274 274 274 274 274 274 274
 100 100 100 283 283 283 283 283 283 283 253 253 209 227 239 240 241 242 243 243 244 245 246 247 236 248 249 250 261 225 251 269 269 226 226 252 252 207 207 173 173 173 274 278 278 274 274 274 274 274 274 274 274 274 274 274 274 274 274 274 274 274 274 274 274 274 274 274 274 274 274 274 274 274 274 274 274 274 274 274 274 274 274 274 274 274 274 274 274 274
 100 100 100 100 283 283 283 283 283 283 253 253 263 277 277 264 264 242 254 243 255 246 246 256 257 258 259 260 261 262 269 269 269 226 282 252 207 207 173 173 173 173 274 278 278 274 274 274 274 274 274 274 274 274 274 274 274 274 274 274 274 274 274 274 274 274 274 274 274 274 274 274 274 274 274 274 274 274 274 274 274 274 274 274 274 274 274 274 274 274
 100 100 100 100 100 283 283 283 283 283 253 253 263 277 277 283 264 283 265 243 255 266 267 257 257 258 268 261 261 273 269 269 269 282 282 252 270 207 173 173 274 274 274 278 278 274 274 274 274 274 274 274 274 274 274 274 274 274 274 274 274 274 274 274 274 274 274 274 274 274 274 274 274 274 274 274 274 274 274 274 274 274 274 274 274 274 274 274 274 274
 100 100 100 100 100 100 283 283 283 253 253 263 263 277 277 283 264 283 275 243 276 276 257 257 257 271 268 272 261 273 269 269 269 282 282 282 270 207 173 274 274 274 278 278 278 274 274 274 274 274 274 274 274 274 274 274 274 274 274 274 274 274 274 274 274 274 274 274 274 274 274 274 274 274 274 274 274 274 274 274 274 274 274 274 274 274 274 274 274 274
 100 100 100 100 100 283 283 283 283 277 277 277 277 277 277 283 264 283 275 275 275 276 276 257 257 271 279 273 273 273 269 269 269 282 282 282 270 207 173 274 274 278 278 278 278 274 274 274 274 274 274 274 274 274 274 274 274 274 274 274 274 274 274 274 274 274 274 274 274 274 274 274 274 274 274 274 274 274 274 274 274 274 274 274 274 274 274 274 274 274
 100 100 100 100 100 100 283 283 283 283 283 283 277 277 277 283 283 283 283 275 275 281 276 281 281 279 279 273 273 273 269 269 269 282 282 282 280 280 173 274 274 274 278 278 278 274 274 274 274 274 274 274 274 274 274 274 274 274 274 274 274 274 274 274 274 274 274 274 274 274 274 274 274 274 274 274 274 274 274 274 274 274 274 274 274 274 274 274 274 274
 100 100 100 100 100 100 100 283 283 283 283 283 283 283 283 283 283 283 283 275 275 281 281 281 281 279 279 279 279 286 269 269 288 282 282 282 280 280 274 274 274 274 278 278 278 274 274 274 274 274 274 274 274 274 274 274 274 274 274 287 274 274 274 274 274 274 274 274 274 274 274 274 274 274 274 274 274 274 274 274 274 274 274 274 274 274 274 274 274 274
 100 100 100 100 100 100 283 283 283 283 283 283 283 283 283 283 283 283 283 275 281 281 281 281 281 279 279 279 286 286 286 288 288 282 282 282 282 280 285 274 274 274 274 278 278 274 274 274 274 274 274 274 274 274 274 274 274 274 287 287 287 274 274 274 274 274 274 274 274 274 274 274 274 274 274 274 274 274 274 274 274 274 274 274 274 274 274 274 274 274
 100 100 100 100 100 100 100 283 283 283 283 283 283 283 283 283 283 283 283 284 284 284 283 283 281 286 286 286 286 286 286 288 288 282 282 282 282 280 285 274 274 274 278 278 278 274 274 274 274 274 274 274 274 274 274 274 274 274 287 287 287 274 274 274 274 274 274 274 274 274 274 274 274 274 274 274 274 274 274 274 274 274 274 274 274 274 274 274 274 274
 100 100 100 100 100 100 283 283 283 283 283 283 283 283 283 283 283 283 283 284 284 284 284 283 286 286 286 286 286 286 286 288 288 282 282 282 282 280 285 274 274 274 274 274 274 274 274 274 274 274 274 274 274 274 274 274 274 274 287 287 287 274 274 274 274 274 274 274 274 274 274 274 274 274 274 274 274 274 287 274 274 274 274 274 274 274 274 274 274 274
 100 100 100 100 100 283 283 283 283 283 283 283 283 283 283 283 283 283 283 284 284 284 284 283 286 286 286 286 286 286 286 288 288 282 282 282 285 285 285 285 274 274 274 274 274 274 274 274 274 274 274 274 274 274 274 274 274 287 287 287 287 274 274 274 274 274 274 274 274 274 274 274 274 274 274 274 274 287 287 274 274 274 274 274 274 274 274 274 274 274
 100 100 100 100 283 283 283 283 283 283 283 283 283 283 283 283 283 283 283 284 284 284 284 283 286 286 286 286 286 286 286 288 288 282 282 282 285 285 285 285 274 274 274 274 274 274 274 274 274 274 274 274 274 274 274 274 287 287 287 287 287 287 274 274 274 274 274 274 274 274 274 274 274 274 274 274 287 287 274 274 274 274 274 274 274 274 274 274 274 274
 100 100 100 283 283 283 283 283 283 283 283 283 283 283 283 283 283 283 283 284 284 284 284 283 286 286 286 286 286 286 286 288 288 282 288 282 285 285 285 285 274 274 274 274 274 274 274 274 274 274 274 274 274 274 274 274 274 287 287 287 287 287 274 274 274 274 274 274 274 274 274 274 287 274 287 287 287 274 274 274 274 274 274 274 274 274 274 274 274 274
 100 100 283 283 283 283 283 283 283 283 283 283 283 283 283 283 283 283 283 284 284 284 284 283 286 286 286 286 286 286 286 288 288 288 288 282 285 274 285 274 274 274 274 274 274 274 274 274 274 274 274 274 274 274 274 274 274 274 287 287 287 287 287 274 274 274 274 274 274 274 274 287 287 287 287 287 274 274 274 274 274 274 274 274 274 274 274 274 274 274
 100 100 100 283 283 283 283 283 283 283 283 283 283 283 283 283 283 283 283 283 284 284 283 283 283 286 286 286 286 286 286 288 288 288 288 288 274 274 285 285 274 274 274 274 274 274 274 274 274 274 274 274 274 274 287 287 274 287 287 287 287 287 287 287 274 274 274 274 274 274 287 287 287 287 287 274 274 274 274 274 274 274 274 274 274 274 274 274 274 274
 100 100 100 100 283 283 283 283 283 283 283 283 283 283 283 283 283 283 283 283 283 284 283 283 283 283 283 283 286 286 286 286 288 288 288 288 274 274 274 274 274 274 274 274 274 274 274 274 274 274 274 274 274 274 274 287 287 287 287 287 287 287 287 287 274 274 274 274 274 274 274 287 287 287 274 274 274 274 274 274 274 274 274 274 274 274 274 274 274 274
 100 100 100 100 100 283 283 283 283 283 283 283 283 283 283 283 283 283 283 283 283 283 283 283 283 283 283 283 283 283 288 288 288 288 288 288 274 274 274 274 274 274 274 274 274 274 274 274 274 274 274 274 274 274 274 287 274 287 287 287 287 287 287 287 287 274 274 274 274 274 287 287 287 274 274 274 274 274 274 274 274 274 274 274 274 287 274 274 274 287
 100 100 100 100 100 100 283 283 283 283 283 283 283 283 283 283 283 283 283 283 283 283 283 283 283 283 283 283 283 283 288 288 288 288 288 288 288 274 274 274 274 274 274 274 274 274 274 274 274 274 274 274 274 274 274 274 274 287 287 287 287 287 287 287 287 287 274 274 274 287 287 287 274 274 274 274 274 274 274 274 274 274 274 274 287 287 287 274 287 287
 100 100 100 100 100 100 100 283 283 283 283 283 283 283 283 283 283 283 283 283 283 283 283 283 283 283 283 283 283 283 288 288 288 288 288 288 288 288 274 274 274 274 274 274 274 274 274 274 274 274 274 274 274 274 274 274 274 274 287 287 287 287 287 287 287 287 287 274 287 287 287 287 287 274 274 274 274 274 274 274 274 274 274 287 287 287 287 287 287 287
 100 100 100 100 100 100 100 100 100 283 283 283 283 283 283 283 283 283 283 283 283 283 283 283 283 283 283 283 283 288 288 288 288 288 288 288 288 288 288 274 274 274 274 274 274 274 274 274 274 274 274 274 274 274 274 274 274 274 287 287 287 287 287 287 287 287 287 287 287 287 287 287 287 287 274 274 274 274 274 274 274 274 287 287 287 287 287 287 287 287
 100 100 100 100 100 100 100 100 100 283 283 283 283 283 283 283 283 283 283 283 283 283 283 283 283 283 283 283 288 288 288 288 288 288 288 288 288 288 288 274 274 274 274 274 274 274 274 274 274 274 274 274 274 274 274 274 274 274 274 287 287 287 287 287 287 287 287 287 287 287 287 287 287 287 287 274 287 274 274 274 274 287 287 287 287 287 287 287 287 287
 100 100 100 100 100 100 100 100 283 283 283 283 283 283 283 283 283 283 283 283 283 283 283 283 283 283 283 288 288 288 288 288 288 288 288 288 288 288 288 274 274 274 274 274 274 274 274 274 274 274 274 274 274 274 274 274 274 274 274 274 287 287 287 287 287 287 287 287 287 287 287 287 287 287 287 287 287 287 274 287 287 287 287 287 287 287 287 287 287 287
 100 100 100 100 100 100 100 100 100 283 283 283 283 283 283 283 283 283 283 283 283 283 283 283 283 283 288 288 288 288 288 288 288 288 288 288 288 288 274 274 274 274 274 274 274 274 274 274 274 274 274 274 274 274 274 274 274 274 274 274 274 287 287 287 287 287 287 287 287 287 287 287 287 287 287 287 287 287 287 287 287 287 287 287 287 287 287 287 287 287
 100 100 100 100 100 100 100 100 100 100 283 283 283 283 283 283 283 283 283 283 283 283 283 283 283 100 288 288 288 288 288 288 288 288 288 288 288 274 274 274 274 274 274 274 274 274 274 274 274 274 274 274 274 274 274 274 274 274 274 274 274 274 287 287 287 287 287 287 287 287 287 287 287 287 287 287 287 287 287 287 287 287 287 287 287 287 287 287 287 287
 100 100 100 100 100 100 100 100 100 100 100 283 100 100 283 283 283 283 283 100 283 283 100 283 100 100 288 288 288 288 288 288 288 288 288 288 288 274 274 274 274 274 274 274 274 274 274 274 274 274 274 274 274 274 274 274 274 274 274 274 274 274 274 287 287 287 287 287 287 287 287 287 287 287 287 287 287 287 287 287 287 287 287 287 287 287 287 287 287 287
 100 100 100 100 100 100 100 100 100 100 100 100 100 100 100 283 283 283 100 100 100 100 100 100 100 288 288 288 288 288 288 288 288 288 288 288 274 274 274 274 274 274 274 274 274 274 274 274 274 274 274 274 274 274 274 274 274 274 274 274 274 274 287 287 287 287 287 287 287 287 287 287 287 287 287 287 287 287 287 287 287 287 287 287 287 287 287 287 287 287
 100 100 100 100 100 100 100 100 100 100 100 100 100 100 100 100 283 100 100 100 100 100 100 100 288 288 288 288 288 288 288 288 288 288 288 274 274 274 274 274 274 274 274 274 274 274 274 274 274 274 274 274 274 274 274 274 274 274 274 274 274 287 287 287 287 287 287 287 287 287 287 287 287 287 287 287 287 287 287 287 287 287 287 287 287 287 287 287 287 287
 100 100 100 100 100 100 100 100 100 100 100 100 100 100 100 100 100 100 100 100 100 100 100 288 288 288 288 288 288 288 288 288 288 288 288 288 274 274 274 274 274 274 274 274 274 274 274 274 274 274 274 274 274 274 274 274 274 274 274 274 287 287 287 287 287 287 287 287 287 287 287 287 287 287 287 287 287 287 287 287 287 287 287 287 287 287 287 287 287 287
 100 100 100 100 100 100 100 100 100 100 100 100 100 100 100 100 100 100 100 100 100 100 288 288 288 288 288 288 288 288 288 288 288 288 288 288 288 274 274 274 274 274 274 274 274 274 274 274 274 274 274 274 274 274 274 274 274 287 274 287 287 287 287 287 287 287 287 287 287 287 287 287 287 287 287 287 287 287 287 287 287 287 287 287 287 287 287 287 287 287
 100 100 100 100 100 100 100 100 100 100 100 100 100 100 100 100 100 100 100 100 100 288 288 288 288 288 288 288 288 288 288 288 288 288 288 288 288 288 274 274 274 274 274 274 274 274 274 274 274 274 274 274 274 274 274 274 287 287 287 287 287 287 287 287 287 287 287 287 287 287 287 287 287 287 287 287 287 287 287 287 287 287 287 287 287 287 287 287 287 287
 100 100 100 100 100 100 100 100 100 100 100 100 100 100 100 100 100 100 100 100 100 100 288 288 288 288 288 288 288 288 288 288 288 288 288 288 288 288 288 274 274 274 274 274 274 274 274 274 274 274 274 274 274 274 274 287 287 287 287 287 287 287 287 287 287 287 287 287 287 287 287 287 287 287 287 287 287 287 287 287 287 287 287 287 287 287 287 287 287 287
