   4   4   4   4   5   5   6   1   2  29  29  13  13  13  13   3  15  16  17  18  46  46  46  46  46  46  46  46  47  48  49  49  49  50  83  83  83  88  88  88  88  88  88  88  88 208 208 208 209 209 209 209 209 209 209 209 209 209 209 209 209 209 209 209 209 209 209 209 209 209 209 153 153 153 153 153 153 153 153 153 153 153 153 153 153 153 153 153 153 153
 573   4   4   4   4   5   6   7   8   9  29  10  11  12  13  14  15  16  17  18  19  20  21  22  44  44  46  46  47  48  49  49  49  50  50  83  83  83  85  88  88  87  87  88 208 208 208 208 208 209 209 209 209 209 209 209 209 209 209 209 209 209 209 209 209 209 209 153 209 209 153 153 153 153 153 153 153 153 153 153 153 153 153 153 153 153 153 153 153 153
 573   4   4   4  23  24  25  26  27  28  29  30  31  32  33  34  35  36  37  38  39  40  41  42  43  44  45  46  47  48  49  49  49  50  83  83  83  83  85  85 123  87  87  88 208 208 208 209 209 209 209 209 209 209 209 209 209 209 209 209 209 209 209 209 209 209 153 153 153 153 153 153 153 153 153 153 153 153 153 153 153 153 153 153 153 153 153 153 153 153
 573 573   4  89  51  52  53  54  55  56  57  58  59  60  61  62  63  64  65  66  67  68  69  70  71  72  73  74  75  76  77  78  79  80  81  82  83  84  85  86 123  87  87  88 208 208 208 209 209 209 209 209 209 209 209 209 209 209 209 209 209 209 209 209 209 209 209 153 153 153 153 153 153 153 153 153 153 153 153 153 153 153 153 153 153 153 153 153 153 153
 573 573  89  89  89  89  90  91  92  93  94  95  96  97  98  99 100 101 102 103 104 105 106 107 108 109 110 111 112 113 114 115 116 117 118 119 120 121 122 180 123 208  87 208 208 208 208 209 209 209 209 209 209 209 209 209 209 209 209 209 209 209 209 209 209 209 209 209 153 153 153 153 153 153 153 153 153 153 153 153 153 153 153 153 153 153 153 153 153 153
 573 573 573 154 154 124 125 126 127 128 129 130 131 132 133 134 135 136 137 138 139 140 141 142 143 144 145 146 147 148 149 150 151 206 118 152 120 180 180 180 123 208 208 208 208 208 208 209 209 209 209 209 209 209 209 209 209 209 209 209 209 209 209 209 209 209 209 209 153 209 153 153 153 153 153 153 153 153 153 153 153 153 153 153 153 153 153 153 153 153
 573 573 154 154 154 154 154 155 156 157 158 159 160 161 162 163 164 165 166 167 168 169 170 171 172 173 174 175 176 148 177 206 206 206 178 179 180 180 180 180 262 262 262 208 208 208 209 209 209 209 209 209 209 209 209 209 209 209 209 209 209 209 209 209 209 209 209 209 209 209 209 153 209 209 153 153 153 153 153 153 153 153 153 153 153 153 153 153 153 153
 573 573 573 210 210 210 181 182 183 184 185 186 187 188 189 190 191 192 193 194 195 196 197 198 199 200 201 202 203 148 177 204 205 206 207 207 262 262 262 262 262 262 208 208 208 208 209 209 209 209 209 209 209 209 209 209 209 209 209 209 209 209 209 209 209 209 209 209 209 209 209 209 209 209 209 153 153 153 153 153 153 153 153 153 153 153 153 153 153 153
 573 573 573 573 210 210 210 211 211 212 213 214 215 216 217 218 219 220 221 222 223 224 225 226 227 228 229 230 231 232 233 234 261 235 207 236 237 237 237 262 262 262 208 208 208 208 209 209 209 209 209 209 209 209 209 209 209 209 209 209 209 209 209 209 209 209 209 209 209 209 209 209 209 209 209 209 153 153 153 153 153 153 153 153 153 153 153 153 153 153
 573 573 573 573 210 210 210 238 239 240 241 242 243 244 245 246 247 248 249 250 251 252 253 254 255 256 257 258 259 232 260 261 261 207 207 237 237 237 237 262 262 262 208 208 208 208 209 209 209 209 209 209 209 209 209 209 209 209 209 209 209 209 209 209 209 209 209 209 209 209 209 209 209 209 209 209 209 153 153 153 153 153 153 153 153 153 153 153 153 153
 573 573 573 573 210 473 263 263 264 264 265 266 267 268 269 270 271 272 273 274 275 276 277 278 279 280 281 282 259 283 284 285 286 287 288 289 289 316 262 262 262 262 208 208 208 208 209 209 209 209 209 209 209 472 472 472 472 209 209 209 209 209 209 209 209 209 209 209 209 209 209 209 209 209 209 209 209 209 153 153 153 153 153 153 153 153 153 153 153 153
 573 573 573 210 210 473 473 473 264 290 291 292 293 294 295 296 297 298 299 300 301 302 303 304 305 306 307 308 309 310 311 312 313 314 342 289 315 316 316 262 262 262 208 208 208 208 209 209 209 209 209 209 472 472 472 472 472 209 209 209 209 209 209 209 209 209 209 209 209 209 209 209 209 209 209 209 209 153 153 153 153 153 153 153 153 153 153 153 153 153
 573 573 573 573 210 473 473 473 317 317 318 319 320 321 322 323 324 325 326 327 328 329 330 331 332 333 334 335 336 337 338 339 340 341 342 343 316 316 316 262 262 262 370 370 208 209 209 209 209 209 209 209 209 472 472 472 209 209 209 209 209 209 209 209 209 209 209 209 209 209 209 209 209 209 209 209 153 153 153 153 153 153 153 153 153 153 153 153 153 153
 573 573 573 573 573 473 473 473 317 317 344 345 346 347 348 349 350 351 352 353 354 355 356 357 358 359 360 361 362 363 364 365 366 367 368 369 316 316 316 262 262 262 370 370 370 495 209 209 209 209 209 209 209 472 472 472 472 209 209 209 209 209 209 209 209 209 209 209 209 209 209 209 209 209 209 153 153 153 153 153 153 153 153 153 153 153 153 153 153 153
 573 573 573 573 473 473 473 473 399 371 372 373 374 375 376 377 378 379 380 381 382 383 384 385 386 387 388 389 390 391 392 393 394 395 396 397 398 316 316 262 262 262 494 370 370 495 209 495 209 495 495 209 209 472 472 472 472 209 209 209 209 209 209 209 209 209 209 209 209 209 209 209 209 209 209 209 153 153 153 153 153 153 153 153 153 153 153 153 153 153
 573 573 573 573 573 473 473 473 399 399 400 400 401 402 403 404 405 406 407 408 409 410 411 412 413 414 415 416 417 418 419 420 421 422 423 424 425 316 262 262 262 262 494 370 370 495 495 495 495 495 495 209 209 472 472 472 472 209 209 209 209 209 209 209 209 209 209 209 209 209 209 209 209 209 209 209 209 153 153 153 153 153 153 153 153 153 153 153 153 153
 573 573 573 573 573 573 573 473 399 399 426 427 428 429 430 431 432 433 434 435 436 437 438 439 440 441 442 443 443 444 445 446 447 448 423 449 450 316 262 262 494 494 494 516 370 495 495 495 495 495 495 472 209 472 472 472 472 472 209 209 209 209 209 209 209 209 209 209 209 209 209 209 209 209 209 209 209 209 153 153 153 153 153 153 153 153 153 153 153 153
 573 573 573 573 573 573 573 473 473 426 426 428 428 451 496 452 453 454 455 456 457 458 459 460 461 462 442 463 464 465 466 467 447 468 423 469 470 471 262 494 494 494 516 516 370 495 495 495 495 495 495 472 472 472 472 472 472 472 209 209 209 209 209 209 209 209 209 209 209 209 209 209 209 209 209 209 209 209 209 153 153 153 153 153 153 153 153 153 153 153
 573 573 573 573 573 573 473 473 473 496 496 496 496 496 496 474 475 476 477 478 479 480 481 460 482 483 484 485 486 465 487 488 489 528 490 512 491 492 493 494 494 516 516 516 516 495 495 495 495 495 495 472 472 472 472 472 472 472 209 209 209 209 209 209 209 209 209 209 209 209 209 153 209 209 153 209 209 209 209 153 153 153 153 153 153 153 153 153 153 153
 573 573 573 573 573 573 573 473 554 517 517 517 496 496 496 518 497 498 519 499 479 500 481 501 502 503 504 505 506 507 508 509 510 528 511 512 513 531 514 494 494 548 515 516 516 495 495 495 495 472 472 472 472 472 472 472 472 209 209 209 209 209 209 209 209 209 209 209 209 209 153 153 153 153 153 153 209 209 153 153 153 153 153 153 153 153 153 153 153 153
 573 573 573 573 573 573 573 554 554 554 517 517 518 518 518 518 554 554 519 499 520 500 521 536 536 522 523 523 523 524 525 526 527 528 529 530 531 531 532 494 494 548 516 516 516 495 495 495 495 472 472 472 472 472 472 472 472 209 209 577 209 209 209 209 209 209 209 209 209 153 153 153 153 153 153 153 153 153 153 153 153 153 153 153 153 153 153 153 153 153
 573 573 573 573 573 573 554 554 554 554 554 517 554 518 518 533 554 554 554 499 534 534 534 535 536 537 538 539 540 541 542 543 544 545 546 552 552 531 570 547 547 548 548 516 516 495 495 472 495 472 472 472 472 472 472 472 472 209 577 577 577 209 209 209 209 209 209 209 153 153 153 153 153 153 153 153 153 153 153 153 153 153 153 153 153 153 153 153 153 153
 573 573 573 573 573 573 573 554 554 554 554 554 554 554 554 533 554 554 554 549 549 555 578 578 550 557 551 551 559 576 542 561 561 552 552 552 552 531 570 553 472 565 516 516 516 495 495 472 472 472 472 472 472 472 472 472 472 209 577 577 577 209 209 209 209 209 209 209 209 153 153 153 153 153 153 153 153 153 209 153 153 153 153 153 153 153 153 153 153 153
 573 573 573 573 573 573 573 573 554 554 573 554 554 554 554 554 554 554 554 567 555 555 556 578 557 557 558 559 559 576 560 561 561 562 562 552 563 531 570 564 472 565 472 472 571 571 571 472 472 472 472 472 472 472 472 472 472 472 577 577 577 209 209 209 209 209 209 209 153 153 153 153 153 153 153 153 153 209 209 209 153 153 153 153 153 153 153 153 153 153
 573 573 573 573 573 573 573 573 573 573 573 573 554 554 554 554 554 554 554 567 566 567 567 578 557 557 568 576 559 576 576 561 561 569 552 552 570 570 570 570 472 472 472 571 571 571 571 472 472 472 472 472 472 472 472 472 472 577 577 577 577 209 209 209 209 209 209 209 209 153 153 153 153 153 153 153 209 209 209 209 153 153 153 153 153 153 153 153 153 153
 573 573 573 573 573 573 573 573 573 573 573 573 554 554 554 554 554 554 554 567 567 567 567 578 557 557 576 576 576 576 576 572 572 569 569 552 570 570 570 570 472 472 472 472 571 571 571 472 472 472 472 472 472 472 472 472 577 577 577 577 577 577 209 209 209 209 209 209 209 209 153 209 209 153 209 209 209 209 209 209 209 153 153 153 153 153 153 153 153 153
 573 573 573 573 573 573 573 573 573 573 573 573 554 554 554 554 554 554 554 567 567 567 567 578 557 557 576 576 576 576 576 572 572 569 580 552 570 570 570 570 472 472 472 472 472 472 472 472 472 472 472 472 472 472 472 472 472 577 577 577 577 209 209 209 209 209 209 209 209 209 209 209 209 209 209 209 209 209 153 209 209 153 153 153 153 153 153 153 153 153
 573 573 573 573 573 573 573 573 573 573 573 573 573 554 554 554 554 554 554 567 567 567 567 578 576 576 576 576 576 576 576 579 579 580 580 552 570 574 570 574 574 472 472 472 472 575 575 472 472 472 472 472 472 472 472 472 472 472 577 577 577 577 209 209 209 209 209 209 209 209 209 209 209 209 209 209 209 153 153 153 153 153 153 153 153 153 153 153 153 153
 573 573 573 573 573 573 573 573 573 573 573 573 573 573 554 554 554 554 554 578 567 567 578 578 578 576 576 576 576 576 576 579 579 580 580 580 574 574 570 570 574 472 581 581 581 575 575 472 472 472 472 472 472 472 577 577 472 577 577 577 577 577 209 209 209 209 209 209 209 209 209 209 209 209 209 209 153 153 153 153 153 153 153 153 153 153 153 153 153 153
 573 573 573 573 573 573 573 573 573 573 573 573 573 554 554 554 554 554 578 578 578 567 578 578 578 578 554 554 576 576 576 576 579 580 580 580 574 574 574 574 574 472 581 581 581 575 575 472 472 472 472 472 472 472 582 577 577 577 577 577 577 577 577 209 209 209 209 209 209 209 209 209 209 209 209 153 153 153 153 153 153 153 153 153 153 583 153 153 153 583
 573 573 573 573 573 573 573 573 573 573 573 573 573 573 554 554 554 578 578 578 578 578 578 578 554 554 554 554 554 554 579 579 579 580 580 580 574 581 581 581 581 581 581 581 581 575 575 472 472 472 472 472 472 582 582 577 582 577 577 577 577 577 577 577 209 209 209 209 209 209 209 209 209 209 153 153 153 153 153 153 153 153 153 153 583 583 583 153 583 583
 573 573 573 573 573 573 573 573 573 573 573 573 573 554 554 554 554 554 578 578 578 578 578 578 554 554 554 554 554 554 579 579 579 580 579 579 579 581 581 581 581 581 581 581 581 472 575 472 472 472 472 472 472 582 582 582 582 577 577 577 577 577 577 577 577 209 209 209 209 209 209 209 209 153 153 153 153 153 153 153 153 153 153 583 583 583 583 583 583 583
 573 573 573 573 573 573 573 573 573 573 573 573 554 554 554 554 554 554 554 578 578 578 578 554 554 554 554 554 554 554 579 579 579 580 579 579 579 579 581 581 581 581 581 581 472 472 472 472 472 472 472 472 582 582 582 582 582 582 577 577 577 577 577 577 577 577 209 209 209 209 209 209 209 209 153 153 153 153 153 153 153 153 583 583 583 583 583 583 583 583
 573 573 573 573 573 573 573 573 573 573 573 573 554 554 554 554 554 554 554 554 578 554 578 578 554 554 554 554 554 579 579 579 579 579 579 579 579 579 579 581 581 581 581 472 472 472 472 472 472 472 472 582 582 582 582 582 582 583 577 577 577 577 577 577 577 577 577 209 209 577 209 577 209 577 153 153 583 153 153 153 153 583 583 583 583 583 583 583 583 583
 573 573 573 573 573 573 573 573 573 573 573 573 573 554 554 554 554 554 554 554 554 554 554 554 554 554 554 554 579 579 579 579 579 579 579 579 579 579 579 581 581 581 472 472 472 472 472 472 472 472 582 582 582 582 582 582 583 583 583 577 577 577 577 577 577 577 577 577 577 577 577 577 577 577 577 583 583 583 153 583 583 583 583 583 583 583 583 583 583 583
 573 573 573 573 573 573 573 573 573 573 573 573 573 573 573 554 554 554 554 554 554 554 554 554 554 554 554 579 579 579 579 579 579 579 579 579 579 579 579 581 581 581 581 472 472 472 472 472 472 582 582 582 582 582 582 583 583 583 583 583 577 577 577 577 577 577 577 577 577 577 577 577 577 577 577 577 583 583 583 583 583 583 583 583 583 583 583 583 583 583
 573 573 573 573 573 573 573 573 573 573 573 573 573 573 573 554 554 554 554 554 554 554 554 554 554 554 579 579 579 579 579 579 579 579 579 579 579 579 472 472 581 581 472 472 472 472 472 472 582 582 582 582 582 582 582 582 583 583 583 583 583 577 577 577 577 577 583 583 577 577 577 577 577 577 577 583 583 583 583 583 583 583 583 583 583 583 583 583 583 583
 573 573 573 573 573 573 573 573 573 573 573 573 573 554 554 554 554 554 554 554 554 554 554 554 554 573 579 579 579 579 579 579 579 579 579 579 579 472 472 472 472 581 472 472 472 472 472 472 472 582 582 583 582 582 582 583 583 583 583 583 583 583 577 577 577 583 583 583 583 577 577 577 577 577 577 583 583 583 583 583 583 583 583 583 583 583 583 583 583 583
 573 573 573 573 573 573 573 573 573 573 573 573 573 573 554 554 554 554 554 573 554 554 573 554 573 573 579 579 579 579 579 579 579 579 579 579 579 472 472 472 472 472 472 472 472 472 472 472 582 582 583 583 583 582 583 583 583 583 583 583 583 583 583 577 583 583 583 583 583 577 577 577 577 577 583 583 583 583 583 583 583 583 583 583 583 583 583 583 583 583
 573 573 573 573 573 573 573 573 573 573 573 573 573 573 573 554 554 554 573 573 573 573 573 573 573 579 579 579 579 579 579 579 579 579 579 579 472 472 472 472 472 472 472 472 472 472 472 472 582 583 583 583 583 583 583 583 583 583 583 583 583 583 583 583 583 583 583 583 577 577 577 577 577 583 583 583 583 583 583 583 583 583 583 583 583 583 583 583 583 583
 573 573 573 573 573 573 573 573 573 573 573 573 573 573 573 573 554 573 573 573 573 573 573 573 579 579 579 579 579 579 579 579 579 579 579 472 472 472 472 472 472 472 472 472 472 472 472 472 472 583 583 583 583 583 583 583 583 583 583 583 583 583 583 583 583 583 583 577 577 577 577 577 577 577 583 583 583 583 583 583 583 583 583 583 583 583 583 583 583 583
 573 573 573 573 573 573 573 573 573 573 573 573 573 573 573 573 573 573 573 573 573 573 573 579 579 579 579 579 579 579 579 579 579 579 579 579 472 472 472 472 472 472 472 472 472 472 472 472 583 583 583 583 583 583 583 583 583 583 583 583 583 583 583 583 583 583 583 583 577 577 577 577 577 583 583 583 583 583 583 583 583 583 583 583 583 583 583 583 583 583
 573 573 573 573 573 573 573 573 573 573 573 573 573 573 573 573 573 573 573 573 573 573 579 579 579 579 579 579 579 579 579 579 579 579 579 579 579 472 472 472 472 472 472 472 472 472 472 583 583 583 583 583 583 583 583 583 583 583 583 583 583 583 583 583 583 583 583 583 583 577 577 577 583 583 583 583 583 583 583 583 583 583 583 583 583 583 583 583 583 583
 573 573 573 573 573 573 573 573 573 573 573 573 573 573 573 573 573 573 573 573 573 579 579 579 579 579 579 579 579 579 579 579 579 579 579 579 579 579 472 472 472 472 472 472 472 472 583 583 583 583 583 583 583 583 583 583 583 583 583 583 583 583 583 583 583 583 583 583 583 583 577 583 583 583 583 583 583 583 583 583 583 583 583 583 583 583 583 583 583 583
 573 573 573 573 573 573 573 573 573 573 573 573 573 573 573 573 573 573 573 573 573 573 579 579 579 579 579 579 579 579 579 579 579 579 579 579 579 579 579 472 472 472 472 472 472 583 583 583 583 583 583 583 583 583 583 583 583 583 583 583 583 583 583 583 583 583 583 583 583 583 583 583 583 583 583 583 583 583 583 583 583 583 583 583 583 583 583 583 583 583
