  77  77  77  77   1   1   3   3  21  21  21   6   8   8   9  11  11  14  14  14  14  15  36  36  36  36  37  38  39  67  67  67  68  69  69  71  72  72  72  72  72 174 174  75  75  75  75  75 106 106 106 106 106  76  76  76  76  76  76  76  76  76  76  76  76  76  76  76  76  76  76  76  76  76  76  76  76  76  76  76  76  76  76  76  76  76  76  76  76  76
  77  77  77  77   1   1   2   3   4   5  21   6   7   8   9  10  11  12  29  13  14  15  36  34  36  36  37  38  39  39  67  67  68  69  69  71  72  72  72  72 174 174 174  75  75  75  75  75  75 106 106 106  76  76  76  76  76  76  76  76  76  76  76  76  76  76  76  76  76  76  76  76  76  76  76  76  76  76  76  76  76  76  76  76  76  76  76  76  76  76
  77  77  77  77  77  16  17  18  19  20  21  22  23  24  25  26  27  28  29  30  31  32  33  34  35  36  37  38  39  40  66  67  68  69  70  71  72  73  72  72 174 174 174  75  75  75  75  75  75 106 106 106  76  76  76  76  76  76  76  76  76  76  76  76  76  76  76  76  76  76  76  76  76  76  76  76  76  76  76  76  76  76  76  76  76  76  76  76  76  76
 107  77  77  77  77  41  42  43  44  45  46  47  48  49  50  51  52  53  54  55  56  57  58  59  60  61  62  63  64  65  66  67  68  69  70  71  72  73 174  74 174 174 174  75  75  75  75  75  75 106 106 106  76  76  76  76  76  76  76  76  76  76  76  76  76  76  76  76  76  76  76  76  76  76  76  76  76  76  76  76  76  76  76  76  76  76  76  76  76  76
 107 107 107  77  77  77  78  79  80  81  82  83  84  85  86  87  88  89  90  91  92  93  94  95  96  97  98  99 100 101 102  67 103 130 104 105  72 174 174  74 174 174 174  75  75  75  75  75  75 106 106 106  76  76  76  76  76  76  76  76  76  76  76  76  76  76  76  76  76  76  76  76  76  76  76  76  76  76  76  76  76  76  76  76  76  76  76  76  76  76
 107 107 107 107 107 108 108 109 110 111 112 113 114 115 116 117 118 119 120 121 122 123 124 125 126 127  98 128 196 196  67  67 129 130 130 130 240 174 174  74 174 174 174 175  75  75  75  75  75  75 106 106  76  76  76  76  76  76  76  76  76  76  76  76  76  76  76  76  76  76  76  76  76  76  76  76  76  76  76  76  76  76  76  76  76  76  76  76  76  76
 107 107 107 107 107 107 176 131 132 133 134 135 136 137 138 139 140 141 142 143 144 145 146 147 148 149 150 151 152 196 173 173 173 219 219 130 240 174 174 174 174 174 174 175 175  75  75  75  75  75 106 106 106  76  76  76  76  76  76  76  76  76  76  76  76  76  76  76  76  76  76  76  76  76  76  76  76  76  76  76  76  76  76  76  76  76  76  76  76  76
 107 107 107 107 107 107 176 153 154 155 156 157 158 159 160 161 162 163 164 165 166 167 168 169 170 193 171 172 196 196 173 173 173 219 219 240 240 174 174 174 174 174 174 175 175  75  75 106 106 106 106 106 106 106  76  76  76  76  76  76  76  76  76  76  76  76  76  76  76  76  76  76  76  76  76  76  76  76  76  76  76  76  76  76  76  76  76  76  76  76
 107 107 107 107 107 107 176 176 176 177 178 179 180 181 182 183 184 185 186 187 188 189 190 191 192 193 194 195 196 196 197 219 173 219 219 240 240 174 174 174 241 174 174 175 175 325 325 106 106 106 106 106 106  76  76  76  76  76  76  76  76  76  76  76  76  76  76  76  76  76  76  76  76  76  76  76  76  76  76  76  76  76  76  76  76  76  76  76  76  76
 107 107 107 107 107 107 176 176 198 199 200 201 202 203 204 205 206 207 208 209 210 211 212 213 214 215 216 217 218 196 219 219 219 219 219 240 240 174 174 241 241 174 174 175 325 325 325 325 106 106 106 106 106  76  76  76  76  76  76  76  76  76  76  76  76  76  76  76  76  76  76  76  76  76  76  76  76  76  76  76  76  76  76  76  76  76  76  76  76  76
 107 107 107 107 107 107 176 220 220 199 221 222 223 224 225 226 227 228 229 230 231 232 233 234 235 236 216 237 218 196 238 219 239 219 219 240 240 305 284 241 241 174 174 175 175 325 325 325 106 106 106 106 106  76  76  76  76  76  76  76  76  76  76  76  76  76  76  76  76  76  76  76  76  76  76  76  76  76  76  76  76  76  76  76  76  76  76  76  76  76
 107 107 107 107 107 107 176 220 242 242 243 244 245 246 247 248 249 250 251 252 253 254 255 256 257 258 259 260 261 262 282 282 239 219 240 240 305 305 284 241 241 174 174 175 175 325 325 325 106 106 106 106  76  76  76  76  76  76  76  76  76  76  76  76  76  76  76  76  76  76  76  76  76  76  76  76  76  76  76  76  76  76  76  76  76  76  76  76  76  76
 107 107 107 107 107 107 176 176 263 263 263 264 287 265 266 267 268 269 270 271 272 273 274 275 276 277 278 279 280 281 282 282 283 283 283 305 305 305 284 241 241 360 174 175 325 325 325 325 106 106 106 106 106  76  76  76  76  76  76  76  76  76  76  76  76  76  76  76  76  76  76  76  76  76  76  76  76  76  76  76  76  76  76  76  76  76  76  76  76  76
 107 107 107 107 107 176 176 176 285 285 285 286 287 288 289 289 290 291 292 293 294 295 296 297 298 299 300 301 302 303 304 282 283 283 283 305 305 305 284 387 387 360 360 325 325 325 325 325 325 106 325 325 106 106  76  76  76  76  76  76  76  76  76  76  76  76  76  76  76  76  76  76  76  76  76  76  76  76  76  76  76  76  76  76  76  76  76  76  76  76
 107 107 107 107 107 107 176 176 326 285 306 306 307 288 308 309 310 311 312 313 314 315 316 317 336 318 319 301 320 321 322 323 324 283 305 305 305 305 284 387 387 360 360 360 325 325 325 325 325 325 325 325 106 106  76  76  76  76  76  76  76  76  76  76  76  76  76  76  76  76  76  76  76  76  76  76  76  76  76  76  76  76  76  76  76  76  76  76  76  76
 107 107 107 107 107 176 176 176 326 326 306 306 307 327 328 329 347 330 331 332 333 334 335 336 336 337 338 339 340 341 342 323 343 344 345 305 305 305 284 387 387 360 360 360 325 325 325 325 325 325 325 325 106 106  76  76  76  76  76  76  76  76  76  76  76  76  76  76  76  76  76  76  76  76  76  76  76  76  76  76  76  76  76  76  76  76  76  76  76  76
 107 107 107 107 107 107 176 176 326 326 306 306 327 327 347 346 347 348 348 332 349 350 351 352 336 353 354 340 340 355 356 357 343 358 345 359 359 284 284 387 387 395 395 360 325 325 325 325 325 325 325 106 106 106  76  76  76  76  76  76  76  76  76  76  76  76  76  76  76  76  76  76  76  76  76  76  76  76  76  76  76  76  76  76  76  76  76  76  76  76
 107 107 107 107 107 107 388 388 388 326 306 306 361 361 347 347 347 348 362 363 379 364 365 366 367 368 354 369 370 371 356 372 373 374 345 375 394 284 284 387 387 395 395 395 325 325 325 325 325 325 325 106 106 106  76  76  76  76  76  76  76  76  76  76  76  76  76  76  76  76  76 410  76  76  76  76  76  76  76  76  76  76  76  76  76  76  76  76  76  76
 107 107 107 107 107 388 388 388 388 326 306 306 388 388 389 389 376 377 377 378 379 379 401 366 380 381 354 382 383 384 385 403 403 374 400 386 394 387 387 387 387 395 395 395 395 325 325 325 325 325 325 106 106 106  76  76  76  76  76  76  76  76  76  76  76  76  76  76  76  76 410 410 410  76  76  76  76  76  76  76  76  76  76  76  76  76  76  76  76  76
 107 107 107 107 107 107 388 388 388 306 306 388 388 388 389 389 389 396 396 379 379 379 401 401 401 390 391 384 384 384 392 403 393 400 400 394 394 406 387 387 387 395 395 395 395 325 325 325 325 325 325 106 106 106  76  76  76  76  76 410  76  76  76  76  76  76 410  76  76 410 410 410 410 410  76  76  76  76  76  76  76  76  76  76  76  76  76  76  76  76
 107 107 107 107 107 107 107 388 388 388 306 388 388 388 389 389 389 396 396 396 397 379 401 401 401 401 398 402 384 399 403 403 403 403 400 404 394 406 406 406 387 395 395 395 395 325 325 325 325 325 325 106 106  76  76  76  76  76 410 410 410  76  76  76  76 410 410 410 410 410 410 410 410 410 410  76  76  76  76  76  76  76  76  76  76  76  76  76  76  76
 107 107 107 107 107 107 388 388 388 388 306 388 388 388 389 389 389 396 396 396 397 401 401 401 401 401 402 402 414 414 403 403 403 403 404 404 394 406 406 406 406 395 395 395 395 325 325 325 325 325 325 106 106 106  76  76  76 410 410 410 410 410 410  76 410 410 410 410 410 410 410 410 410 410 410  76  76  76  76  76  76  76  76  76  76  76  76  76  76  76
 107 107 107 107 107 107 388 388 388 388 306 388 388 389 389 389 389 396 396 396 396 401 401 401 401 401 402 402 414 414 403 403 403 403 405 404 408 406 406 406 406 395 409 395 409 325 325 325 325 415 325 106 106 106 410  76  76 410 410 410 410 410 410 410 410 410 410 410 410 410 410 410 410 410  76  76  76  76  76  76  76  76  76  76  76  76  76  76  76  76
 107 107 107 107 107 388 388 388 388 388 306 388 388 389 389 389 389 396 415 396 412 401 401 411 411 411 407 407 407 414 414 414 414 403 405 404 408 408 408 406 406 409 409 409 409 325 325 325 415 415 325 106 106 106 410 410  76 410 410 410 410 410 410 410 410 410 410 410 410 410 410 410 410 410  76  76  76  76  76  76  76  76  76  76  76  76  76  76  76  76
 107 107 107 107 388 388 388 388 388 388 388 388 388 388 388 389 389 396 415 415 412 401 401 411 411 411 414 407 407 414 414 414 405 405 405 404 408 408 408 406 406 409 409 409 409 325 415 415 415 415 106 106 106 415 410  76  76 410 410 410 410 410 410 410 410 410 410 410 410 410 410 410 410  76  76  76  76  76  76  76  76  76  76  76  76  76  76  76  76  76
 107 107 107 388 388 388 388 388 388 388 388 388 388 388 413 389 389 396 415 415 412 401 411 411 411 411 414 414 414 414 414 414 415 415 415 415 408 408 408 406 406 409 409 409 409 415 415 415 415 415 415 415 415 415 410 410 410 410 410 410 410 410 410 410 410 410 410 410 410 410 410 410  76  76  76  76  76  76  76  76  76  76  76  76  76  76  76  76  76  76
 107 107 388 388 388 388 388 388 388 388 388 388 388 413 413 389 389 396 415 412 412 412 412 411 411 411 414 414 414 414 414 414 415 415 415 415 408 408 408 406 409 409 409 409 409 415 415 415 415 415 415 415 415 415 415 410 410 410 410 410 410 410 410 410 410 410 410 410 410 410 410 410 410  76  76  76  76  76  76  76  76  76  76  76  76  76  76  76  76  76
 107 388 388 388 388 388 388 388 388 388 388 388 388 413 413 389 389 396 415 412 412 412 412 411 415 411 411 414 414 414 414 415 415 415 415 415 408 408 408 415 409 409 415 409 409 415 415 415 415 415 415 415 415 415 410 410 410 410 410 410 410 410 410 410 410 410 410 410 410 410 410 410  76  76  76  76  76  76  76  76  76  76  76  76  76  76  76  76  76  76
 107 107 388 388 388 388 388 388 388 388 388 388 388 413 413 389 389 396 415 415 412 412 412 412 415 411 411 414 414 414 414 415 415 415 415 415 415 415 415 415 409 415 415 409 409 415 415 415 415 415 415 415 415 415 415 410 410 410 410 410 410 410 410 410 410 410 410 410 410 410 410  76  76  76  76  76  76  76  76  76  76  76  76  76  76  76  76  76  76  76
 107 107 107 388 388 388 388 388 388 388 388 388 388 413 413 413 413 415 415 415 415 415 415 415 415 415 414 414 414 414 414 415 415 415 415 415 415 415 415 409 409 415 409 409 409 415 415 415 415 415 415 415 415 415 415 410 410 410 410 410 410 410 410 410 410 410 410 410 410 410  76  76  76  76  76  76  76  76  76  76  76  76  76  76  76  76  76  76  76  76
 107 107 107 107 388 388 388 388 388 388 388 388 413 413 413 413 413 415 415 415 415 415 415 415 415 415 414 414 414 414 414 415 415 415 415 415 415 415 409 409 409 415 409 409 409 415 415 415 415 415 415 415 415 415 415 410 415 410 410 410 410 410 410  76  76 410 410 410 410  76  76  76  76  76  76  76  76  76  76  76  76  76  76  76  76  76  76  76  76  76
 107 107 107 107 107 388 388 388 388 388 388 107 107 413 413 413 413 415 415 415 415 415 415 415 415 415 415 415 415 415 414 415 415 415 415 415 415 415 409 409 409 415 415 409 409 415 415 415 415 415 415 415 415 415 415 415 415 410 410 410 410 410 410 410  76  76  76 410  76  76  76  76  76  76  76  76  76  76  76  76  76  76  76  76  76  76  76  76  76  76
 107 107 107 107 107 107 388 388 388 388 107 107 413 413 413 413 415 415 415 415 415 415 415 415 415 415 415 415 415 415 415 415 415 415 415 415 415 415 409 409 409 415 415 415 415 415 415 415 415 415 415 415 415 415 415 415 415 410 410 410 410 410 410 410 410  76  76  76  76  76  76  76  76  76  76  76  76  76  76  76  76  76  76  76  76  76  76  76  76  76
 107 107 107 107 107 107 107 388 388 107 107 413 413 413 413 413 415 415 415 415 415 415 415 415 415 415 415 415 415 415 415 415 415 415 415 415 415 415 409 415 415 415 415 415 415 415 415 415 415 415 415 415 415 415 415 415 415 410 410 410 410 410 410 410 410 410  76  76  76  76  76  76  76  76  76  76  76  76  76  76  76  76  76  76  76  76  76  76  76  76
 107 107 107 107 107 107 107 107 107 107 413 413 413 413 413 415 415 415 415 415 415 415 415 415 415 415 415 415 415 415 415 415 415 415 415 415 415 415 415 415 415 415 415 415 415 415 415 415 415 415 415 415 415 415 415 415 410 410 410 410 410 410 410 410 410 410 410  76  76  76  76  76  76  76  76  76  76  76  76  76  76  76  76  76  76  76  76  76  76  76
 107 107 107 107 107 107 107 107 107 107 107 413 107 107 413 415 415 415 415 415 415 415 415 415 415 415 415 415 415 415 415 415 415 415 415 415 415 415 415 415 415 415 415 415 415 415 415 415 415 410 410 415 415 415 415 410 410 410 410 410 410 410 410 410 410 410  76  76  76  76  76  76  76  76  76  76  76  76  76  76  76  76  76  76  76  76  76  76  76  76
 107 107 107 107 107 107 107 107 107 107 107 107 107 413 413 413 415 415 415 415 415 415 415 415 415 415 415 415 415 415 415 415 415 415 415 415 415 415 415 415 415 415 415 415 415 415 415 415 410 410 410 410 415 415 410 410 410 410 410 410 410 410 410 410 410  76  76  76  76  76  76  76  76  76  76  76  76  76  76  76  76  76  76  76  76  76  76  76  76  76
 107 107 107 107 107 107 107 107 107 107 107 107 413 413 413 413 413 107 415 415 415 415 415 415 415 415 415 415 415 415 415 415 415 415 415 415 415 415 415 415 415 415 415 415 415 415 415 410 410 410 410 410 410 410 410 410 410 410 410 410 410 410 410 410  76  76  76  76  76  76  76  76  76  76  76  76  76  76  76  76  76  76  76  76  76  76  76  76  76  76
 107 107 107 107 107 107 107 107 107 107 107 107 107 413 413 413 107 107 107 415 415 415 107 415 415 415 415 415 415 415 415 415 415 415 415 415 415 415 415 415 415 415 415 415 415 415 410 410 410 410 410 410 410 410 410 410 410 410 410 410 410 410 410 410  76  76  76  76  76  76  76  76  76  76  76  76  76  76  76  76  76  76  76  76  76  76  76  76  76  76
 107 107 107 107 107 107 107 107 107 107 107 107 107 107 413 107 107 107 107 107 415 107 107 415 415 415 415 415 415 415 415 415 415 410 410 415 415 415 415 410 410 415 415 415 415 415 415 410 410 410 410 410 410 410 410 410 410 410 410 410 410 410 410  76  76  76  76  76  76  76  76  76  76  76  76  76  76  76  76  76  76  76  76  76  76  76  76  76  76  76
 107 107 107 107 107 107 107 107 107 107 107 107 107 107 107 107 107 107 107 107 107 107 415 415 415 415 415 415 415 415 415 415 415 415 410 410 410 415 415 415 410 415 415 415 415 415 415 415 410 410 410 410 410 410 410  76 410  76  76 410 410 410  76  76  76  76  76  76  76  76  76  76  76  76  76  76  76  76  76  76  76  76  76  76  76  76  76  76  76  76
 107 107 107 107 107 107 107 107 107 107 107 107 107 107 107 107 107 107 107 107 107 415 415 415 415 415 415 415 415 415 415 415 415 415 415 410 410 410 415 410 410 410 415 415 415 415 415 410 410 410 410 410 410  76  76  76  76  76  76  76 410  76  76  76  76  76  76  76  76  76  76  76  76  76  76  76  76  76  76  76  76  76  76  76  76  76  76  76  76  76
 107 107 107 107 107 107 107 107 107 107 107 107 107 107 107 107 107 107 107 107 415 415 415 415 415 415 415 415 415 415 415 415 415 415 415 415 410 410 410 410 410 410 410 415 415 415 410 410 410 410 410 410 410  76  76  76  76  76  76  76  76  76  76  76  76  76  76  76  76  76  76  76  76  76  76  76  76  76  76  76  76  76  76  76  76  76  76  76  76  76
 107 107 107 107 107 107 107 107 107 107 107 107 107 107 107 107 107 107 107 415 415 415 415 415 415 415 415 415 415 415 415 415 415 415 415 415 415 410 410 410 410 410 410 410 415 410 410 410 410 410 410 410  76  76  76  76  76  76  76  76  76  76  76  76  76  76  76  76  76  76  76  76  76  76  76  76  76  76  76  76  76  76  76  76  76  76  76  76  76  76
 107 107 107 107 107 107 107 107 107 107 107 107 107 107 107 107 107 107 107 107 415 415 415 415 415 415 415 415 415 415 415 415 415 415 415 415 415 415 410 410 410 410 410 410 410 410 410 410 410 410 410  76  76  76  76  76  76  76  76  76  76  76  76  76  76  76  76  76  76  76  76  76  76  76  76  76  76  76  76  76  76  76  76  76  76  76  76  76  76  76
