 101 101 101 101   1   1   4   4   4   4   4   7   7   7   8   9   9  16  16  16  16  16  16  16  16  16  40  40  40  40  40  40 126  60  60  60 100 100 100 100 100 100 100 182 182 182 182 182 182 182 182 182 182 182 182 182 182 182 182 182 182 182 182 182 182 182 182 182 182 182 182 182 182 182 182 182 182 182 182 182 182 182 182 182 182 182 182 182 182 182
 101 101 101 101   1   1   1   4   4   4   4   7   7   7   8   9   9  11  12  13  16  16  16  16  16  16  40  40  40  40  40  40 126  60  60  60 100 100 100 100 100 100 100 182 182 182 182 182 182 182 182 182 182 182 182 182 182 182 182 182 182 182 182 182 182 182 182 182 182 182 182 182 182 182 182 182 182 182 182 182 182 182 182 182 182 182 182 182 182 182
 101 101 101 101 101   1   1   2   4   3   4   5   6   7   8   9  10  11  12  13  14  15  33  16  16  16  40  40  40  39  40  40 126  60  60  60 100 100 100 100 100 100 100 182 182 182 182 182 182 182 182 182 182 182 182 182 182 182 182 182 182 182 182 182 182 182 182 182 182 182 182 182 182 182 182 182 182 182 182 182 182 182 182 182 182 182 182 182 182 182
 101 101 101 101 101   1  17  18  19  20  21  22  23  24  25  26  27  28  29  30  31  32  33  34  35  36  37  38 114  39  40  40 126  60  60  60 100 100 100 100 100 100 100 182 182 182 182 182 182 182 182 182 182 182 182 182 182 182 182 182 182 182 182 182 182 182 182 182 182 182 182 182 182 182 182 182 182 182 182 182 182 182 182 182 182 182 182 182 182 182
 101 101 101 101 101 101 101  41  42  43  44  45  46  47  48  49  50  51  52  53  54  55  56  57  58  59  59 114 114 114  40  40 126 163 163  60 100 100 100 100 100 100 100 182 182 182 182 182 182 182 182 182 182 182 182 182 182 182 182 182 182 182 182 182 182 182 182 182 182 182 182 182 182 182 182 182 182 182 182 182 182 182 182 182 182 182 182 182 182 182
 101 101 101 101 101 101 101  61  61  62  63  64  65  66  67  68  69  70  71  72  73  99  99  74  59  59  59 114 114 114  40  40 126 163 163 163 163 100 100 100 100 100 100 168 182 182 182 182 182 182 182 182 182 182 182 182 182 182 182 182 182 182 182 182 182 182 182 182 182 182 182 182 182 182 182 182 182 182 182 182 182 182 182 182 182 182 182 182 182 182
 101 101 101 101 101 101 101 101 101  62  75  76  77  78  79  80  81  82  83  84  85  99  99  99  59  86  86 114 114 114 126 126 126 126 126 163 163 100 100 100 100 100 100 168 168 182 182 182 182 182 182 182 182 182 182 182 182 182 182 182 182 182 182 182 182 182 182 182 182 182 182 182 182 182 182 182 182 182 182 182 182 182 182 182 182 182 182 182 182 182
 101 101 101 101 101 101 101 101 101  87  88  89  90  91  92  93  94  95  96 111  97  98  99  99  86  86  86 114 114 114 126 126 126 126 126 163 163 100 100 100 100 100 100 168 168 182 182 182 182 182 182 182 182 182 182 182 182 182 182 182 182 182 182 182 182 182 182 182 182 182 182 182 182 182 182 182 182 182 182 182 182 182 182 182 182 182 182 182 182 182
 101 101 101 101 101 101 101 101 101 102 103 104 105 106 107 108 109 110 111 111 112 125 113  99  86  86 114 114 114 114 126 126 126 126 126 163 163 100 100 100 100 100 100 168 168 168 168 182 182 182 182 182 182 182 182 182 182 182 182 182 182 182 182 182 182 182 182 182 182 182 182 182 182 182 182 182 182 182 182 182 182 182 182 182 182 182 182 182 182 182
 101 101 101 101 101 101 101 101 101 101 115 116 116 117 118 119 120 121 122 123 124 125  99  99 114 114 114 114 114 114 126 126 126 126 126 163 163 100 100 100 100 100 100 168 168 168 168 168 182 182 182 182 182 182 182 182 182 182 182 182 182 182 182 182 182 182 182 182 182 182 182 182 182 182 182 182 182 182 182 182 182 182 182 182 182 182 182 182 182 182
 101 101 101 101 101 101 101 101 101 101 155 116 116 127 128 129 130 131 132 133 134 135  99 136 114 114 114 114 114 114 126 126 126 126 126 163 163 163 163 100 100 100 100 168 168 168 168 168 182 182 182 182 182 182 182 182 182 182 182 182 182 182 182 182 182 182 182 182 182 182 182 182 182 182 182 182 182 182 182 182 182 182 182 182 182 182 182 182 182 182
 101 101 101 101 101 101 101 101 101 101 155 116 137 127 138 156 139 140 141 142 143 143 143 144 145 114 114 162 114 114 153 153 126 126 163 163 163 163 163 100 100 100 100 168 168 168 168 168 182 182 182 182 182 182 182 182 182 182 182 182 182 182 182 182 182 182 182 182 182 182 182 182 182 182 182 182 182 182 182 182 182 182 182 182 182 182 182 182 182 182
 101 101 101 101 101 101 101 101 155 155 155 155 155 156 146 156 147 148 142 142 149 150 143 151 152 114 162 162 167 114 153 153 154 154 154 163 163 163 163 100 100 182 100 168 168 168 168 168 182 182 182 182 182 182 182 182 182 182 182 182 182 182 182 182 182 182 182 182 182 182 182 182 182 182 182 182 182 182 182 182 182 182 182 182 182 182 182 182 182 182
 101 101 101 101 101 101 101 101 155 155 155 155 155 156 156 156 157 148 158 159 160 161 169 169 169 114 162 162 167 153 153 153 154 154 154 163 163 163 163 182 182 182 182 168 168 168 168 168 168 182 168 168 182 182 182 182 182 182 182 182 182 182 182 182 182 182 182 182 182 182 182 182 182 182 182 182 182 182 182 182 182 182 182 182 182 182 182 182 182 182
 101 101 101 101 101 101 101 101 164 155 164 164 156 156 156 156 170 171 165 169 160 169 166 166 169 114 162 162 167 153 153 153 180 154 163 163 163 163 163 182 182 182 182 182 168 168 168 168 168 168 168 168 182 182 182 182 182 182 182 182 182 182 182 182 182 182 182 182 182 182 182 182 182 182 182 182 182 182 182 182 182 182 182 182 182 182 182 182 182 182
 101 101 101 101 101 101 101 101 164 164 164 164 156 156 170 170 170 171 171 169 169 169 169 169 169 172 172 162 153 153 153 153 180 163 163 163 163 163 163 182 182 182 182 182 168 168 168 168 168 168 168 168 182 182 182 182 182 182 182 182 182 182 182 182 182 182 182 182 182 182 182 182 182 182 182 182 182 182 182 182 182 182 182 182 182 182 182 182 182 182
 101 101 101 101 101 101 101 101 164 164 164 164 156 156 170 170 170 171 171 169 174 169 169 169 169 172 172 153 153 173 173 180 180 180 163 163 163 163 163 182 182 182 182 182 168 168 168 168 168 168 168 182 182 182 182 182 182 182 182 182 182 182 182 182 182 182 182 182 182 182 182 182 182 182 182 182 182 182 182 182 182 182 182 182 182 182 182 182 182 182
 101 101 101 101 101 182 182 182 182 164 164 164 170 170 170 170 170 171 171 174 174 169 179 169 169 179 172 153 153 173 173 180 180 180 163 177 177 163 163 182 182 182 182 182 168 168 168 168 168 168 168 182 182 182 182 182 182 182 182 182 182 182 182 182 182 182 182 182 182 182 182 182 182 182 182 182 182 182 182 182 182 182 182 182 182 182 182 182 182 182
 101 101 101 101 182 182 182 182 182 164 164 164 182 182 176 176 170 174 174 174 174 174 179 169 179 179 172 175 175 175 173 180 180 180 180 177 177 182 182 182 182 182 182 182 182 168 168 168 168 168 168 182 182 182 182 182 182 182 182 182 182 182 182 182 182 182 182 182 182 182 182 182 182 182 182 182 182 182 182 182 182 182 182 182 182 182 182 182 182 182
 101 101 101 101 101 182 182 182 182 164 164 182 182 182 176 176 176 178 178 174 174 174 179 179 179 179 172 175 175 175 173 180 180 180 180 177 177 182 182 182 182 182 182 182 182 168 168 168 168 168 168 182 182 182 182 182 182 182 182 182 182 182 182 182 182 182 182 182 182 182 182 182 182 182 182 182 182 182 182 182 182 182 182 182 182 182 182 182 182 182
 101 101 101 101 101 101 182 182 182 182 164 182 182 182 176 176 176 178 178 178 174 174 179 179 179 179 181 181 175 181 180 180 180 180 180 182 177 182 182 182 182 182 182 182 182 168 168 168 168 168 168 182 182 182 182 182 182 182 182 182 182 182 182 182 182 182 182 182 182 182 182 182 182 182 182 182 182 182 182 182 182 182 182 182 182 182 182 182 182 182
 101 101 101 101 101 182 182 182 182 182 164 182 182 182 176 176 176 178 178 178 174 179 179 179 179 179 181 181 181 181 180 180 180 180 182 182 177 182 182 182 182 182 182 182 182 168 168 168 168 168 168 182 182 182 182 182 182 182 182 182 182 182 182 182 182 182 182 182 182 182 182 182 182 182 182 182 182 182 182 182 182 182 182 182 182 182 182 182 182 182
 101 101 101 101 101 182 182 182 182 182 164 182 182 176 176 176 176 178 178 178 178 179 179 179 179 179 181 181 181 181 180 180 180 180 182 182 182 182 182 182 182 182 182 182 182 168 168 168 168 182 168 182 182 182 182 182 182 182 182 182 182 182 182 182 182 182 182 182 182 182 182 182 182 182 182 182 182 182 182 182 182 182 182 182 182 182 182 182 182 182
 101 101 101 101 182 182 182 182 182 182 164 182 182 176 176 176 176 178 182 178 182 179 179 182 182 182 181 181 181 181 181 181 181 180 182 182 182 182 182 182 182 182 182 182 182 168 168 168 182 182 168 182 182 182 182 182 182 182 182 182 182 182 182 182 182 182 182 182 182 182 182 182 182 182 182 182 182 182 182 182 182 182 182 182 182 182 182 182 182 182
 101 101 101 182 182 182 182 182 182 182 182 182 182 182 182 176 176 178 182 182 182 179 179 182 182 182 181 181 181 181 181 181 182 182 182 182 182 182 182 182 182 182 182 182 182 168 182 182 182 182 182 182 182 182 182 182 182 182 182 182 182 182 182 182 182 182 182 182 182 182 182 182 182 182 182 182 182 182 182 182 182 182 182 182 182 182 182 182 182 182
 101 101 182 182 182 182 182 182 182 182 182 182 182 182 182 176 176 178 182 182 182 179 182 182 182 182 181 181 181 181 181 181 182 182 182 182 182 182 182 182 182 182 182 182 182 182 182 182 182 182 182 182 182 182 182 182 182 182 182 182 182 182 182 182 182 182 182 182 182 182 182 182 182 182 182 182 182 182 182 182 182 182 182 182 182 182 182 182 182 182
 101 182 182 182 182 182 182 182 182 182 182 182 182 182 182 176 176 178 182 182 182 182 182 182 182 182 181 181 181 181 181 181 182 182 182 182 182 182 182 182 182 182 182 182 182 182 182 182 182 182 182 182 182 182 182 182 182 182 182 182 182 182 182 182 182 182 182 182 182 182 182 182 182 182 182 182 182 182 182 182 182 182 182 182 182 182 182 182 182 182
 182 182 182 182 182 182 182 182 182 182 182 182 182 182 182 176 176 178 182 182 182 182 182 182 182 182 182 181 181 181 181 182 182 182 182 182 182 182 182 182 182 182 182 182 182 182 182 182 182 182 182 182 182 182 182 182 182 182 182 182 182 182 182 182 182 182 182 182 182 182 182 182 182 182 182 182 182 182 182 182 182 182 182 182 182 182 182 182 182 182
 182 182 182 182 182 182 182 182 182 182 182 182 182 182 182 176 176 178 182 182 182 182 182 182 182 182 182 181 181 181 181 182 182 182 182 182 182 182 182 182 182 182 182 182 182 182 182 182 182 182 182 182 182 182 182 182 182 182 182 182 182 182 182 182 182 182 182 182 182 182 182 182 182 182 182 182 182 182 182 182 182 182 182 182 182 182 182 182 182 182
 182 182 182 182 182 182 182 182 182 182 182 182 182 182 182 182 182 182 182 182 182 182 182 182 182 182 181 181 181 181 181 182 182 182 182 182 182 182 182 182 182 182 182 182 182 182 182 182 182 182 182 182 182 182 182 182 182 182 182 182 182 182 182 182 182 182 182 182 182 182 182 182 182 182 182 182 182 182 182 182 182 182 182 182 182 182 182 182 182 182
 182 182 182 182 182 182 182 182 182 182 182 182 182 182 182 182 182 182 182 182 182 182 182 182 182 182 181 181 181 181 181 182 182 182 182 182 182 182 182 182 182 182 182 182 182 182 182 182 182 182 182 182 182 182 182 182 182 182 182 182 182 182 182 182 182 182 182 182 182 182 182 182 182 182 182 182 182 182 182 182 182 182 182 182 182 182 182 182 182 182
 182 182 182 182 182 182 182 182 182 182 182 182 182 182 182 182 182 182 182 182 182 182 182 182 182 182 182 182 182 182 181 182 182 182 182 182 182 182 182 182 182 182 182 182 182 182 182 182 182 182 182 182 182 182 182 182 182 182 182 182 182 182 182 182 182 182 182 182 182 182 182 182 182 182 182 182 182 182 182 182 182 182 182 182 182 182 182 182 182 182
 182 182 182 182 182 182 182 182 182 182 182 182 182 182 182 182 182 182 182 182 182 182 182 182 182 182 182 182 182 182 182 182 182 182 182 182 182 182 182 182 182 182 182 182 182 182 182 182 182 182 182 182 182 182 182 182 182 182 182 182 182 182 182 182 182 182 182 182 182 182 182 182 182 182 182 182 182 182 182 182 182 182 182 182 182 182 182 182 182 182
 182 182 182 182 182 182 182 182 182 182 182 182 182 182 182 182 182 182 182 182 182 182 182 182 182 182 182 182 182 182 182 182 182 182 182 182 182 182 182 182 182 182 182 182 182 182 182 182 182 182 182 182 182 182 182 182 182 182 182 182 182 182 182 182 182 182 182 182 182 182 182 182 182 182 182 182 182 182 182 182 182 182 182 182 182 182 182 182 182 182
 182 182 182 182 182 182 182 182 182 182 182 182 182 182 182 182 182 182 182 182 182 182 182 182 182 182 182 182 182 182 182 182 182 182 182 182 182 182 182 182 182 182 182 182 182 182 182 182 182 182 182 182 182 182 182 182 182 182 182 182 182 182 182 182 182 182 182 182 182 182 182 182 182 182 182 182 182 182 182 182 182 182 182 182 182 182 182 182 182 182
 182 182 182 182 182 182 182 182 182 182 182 182 182 182 182 182 182 182 182 182 182 182 182 182 182 182 182 182 182 182 182 182 182 182 182 182 182 182 182 182 182 182 182 182 182 182 182 182 182 182 182 182 182 182 182 182 182 182 182 182 182 182 182 182 182 182 182 182 182 182 182 182 182 182 182 182 182 182 182 182 182 182 182 182 182 182 182 182 182 182
 182 182 182 182 182 182 182 182 182 182 182 182 182 182 182 182 182 182 182 182 182 182 182 182 182 182 182 182 182 182 182 182 182 182 182 182 182 182 182 182 182 182 182 182 182 182 182 182 182 182 182 182 182 182 182 182 182 182 182 182 182 182 182 182 182 182 182 182 182 182 182 182 182 182 182 182 182 182 182 182 182 182 182 182 182 182 182 182 182 182
 182 182 182 182 182 182 182 182 182 182 182 182 182 182 182 182 182 182 182 182 182 182 182 182 182 182 182 182 182 182 182 182 182 182 182 182 182 182 182 182 182 182 182 182 182 182 182 182 182 182 182 182 182 182 182 182 182 182 182 182 182 182 182 182 182 182 182 182 182 182 182 182 182 182 182 182 182 182 182 182 182 182 182 182 182 182 182 182 182 182
 182 182 182 182 182 182 182 182 182 182 182 182 182 182 182 182 182 182 182 182 182 182 182 182 182 182 182 182 182 182 182 182 182 182 182 182 182 182 182 182 182 182 182 182 182 182 182 182 182 182 182 182 182 182 182 182 182 182 182 182 182 182 182 182 182 182 182 182 182 182 182 182 182 182 182 182 182 182 182 182 182 182 182 182 182 182 182 182 182 182
 182 182 182 182 182 182 182 182 182 182 182 182 182 182 182 182 182 182 182 182 182 182 182 182 182 182 182 182 182 182 182 182 182 182 182 182 182 182 182 182 182 182 182 182 182 182 182 182 182 182 182 182 182 182 182 182 182 182 182 182 182 182 182 182 182 182 182 182 182 182 182 182 182 182 182 182 182 182 182 182 182 182 182 182 182 182 182 182 182 182
 182 182 182 182 182 182 182 182 182 182 182 182 182 182 182 182 182 182 182 182 182 182 182 182 182 182 182 182 182 182 182 182 182 182 182 182 182 182 182 182 182 182 182 182 182 182 182 182 182 182 182 182 182 182 182 182 182 182 182 182 182 182 182 182 182 182 182 182 182 182 182 182 182 182 182 182 182 182 182 182 182 182 182 182 182 182 182 182 182 182
 182 182 182 182 182 182 182 182 182 182 182 182 182 182 182 182 182 182 182 182 182 182 182 182 182 182 182 182 182 182 182 182 182 182 182 182 182 182 182 182 182 182 182 182 182 182 182 182 182 182 182 182 182 182 182 182 182 182 182 182 182 182 182 182 182 182 182 182 182 182 182 182 182 182 182 182 182 182 182 182 182 182 182 182 182 182 182 182 182 182
 182 182 182 182 182 182 182 182 182 182 182 182 182 182 182 182 182 182 182 182 182 182 182 182 182 182 182 182 182 182 182 182 182 182 182 182 182 182 182 182 182 182 182 182 182 182 182 182 182 182 182 182 182 182 182 182 182 182 182 182 182 182 182 182 182 182 182 182 182 182 182 182 182 182 182 182 182 182 182 182 182 182 182 182 182 182 182 182 182 182
 182 182 182 182 182 182 182 182 182 182 182 182 182 182 182 182 182 182 182 182 182 182 182 182 182 182 182 182 182 182 182 182 182 182 182 182 182 182 182 182 182 182 182 182 182 182 182 182 182 182 182 182 182 182 182 182 182 182 182 182 182 182 182 182 182 182 182 182 182 182 182 182 182 182 182 182 182 182 182 182 182 182 182 182 182 182 182 182 182 182
 182 182 182 182 182 182 182 182 182 182 182 182 182 182 182 182 182 182 182 182 182 182 182 182 182 182 182 182 182 182 182 182 182 182 182 182 182 182 182 182 182 182 182 182 182 182 182 182 182 182 182 182 182 182 182 182 182 182 182 182 182 182 182 182 182 182 182 182 182 182 182 182 182 182 182 182 182 182 182 182 182 182 182 182 182 182 182 182 182 182
