 105 105 105 105 105 105   1   2   5   5   5   6   8   8   9  11  11  12  12  13  14  15  15  36  36  36  36  36  39  68  68  68  68  68  68  70  72  72  72  72  72  73  73  73  73  73  73  73  73  73  73 104 104 104 104 104 104 104 104 104 104 401 401 401 401 401 401 401 401 401 401 401 401 401 401 401 401 401 401 401 401 401 401 401 401 401 401 401 401 401
 105 105 105 105 105  16   1   2   3   4   5   6   7   8   9  10  11  12  29  13  14  15  33  36  36  36  36  38  39  65  65  68  68  68  68  70  72  72  72  72  73  73  73  73  73  73  73  73  73  73  73  73 104 104 104 104 104 104 104 104 401 401 401 401 401 401 401 401 401 401 401 401 401 401 401 401 401 401 401 401 401 401 401 401 401 401 401 401 401 401
 105 105 105 105  16  16  17  18  19  20  21  22  23  24  25  26  27  28  29  30  31  32  33  34  35  36  37  38  39  65  65  68  68  68  69  70  71  72  72  72  73  73  73  73  73  73  73  73  73  73  73  73 104 104 104 104 104 104 104 401 401 401 401 401 401 401 401 401 401 401 401 401 401 401 401 401 401 401 401 401 401 401 401 401 401 401 401 401 401 401
 105 105 105 105  40  40  41  42  43  44  45  46  47  48  49  50  51  52  53  54  55  56  57  58  59  60  61  62  63  64  65  66  67  68  69  70  71 148  72 148 301  73  73  73  73  73  73  73  73 376  73  73 104 104 104 104 104 104 401 401 401 401 401 401 401 401 401 401 401 401 401 401 401 401 401 401 401 401 401 401 401 401 401 401 401 401 401 401 401 401
 168 105 105 105  74  74  75  76  77  78  79  80  81  82  83  84  85  86  87  88  89  90  91  92  93  94  95  96  97  98  99  66 100 101 102 103 148 148 148 148 301  73  73  73  73  73  73  73  73 376 376 376 104 104 104 104 104 401 401 401 401 401 401 401 401 401 401 401 401 401 401 401 401 401 401 401 401 401 401 401 401 401 401 401 401 401 401 401 401 401
 168 168 168 105 105 105 105 106 107 108 109 110 111 112 113 114 115 116 117 118 119 120 121 122 123 124 125 126 189 189  66  66 167 101 102 148 148 148 148 148 301  73  73  73  73  73  73  73  73 376 376 376 104 104 104 104 104 104 401 401 401 401 401 401 401 401 401 401 401 401 401 401 401 401 401 401 401 401 401 401 401 401 401 401 401 401 401 401 401 401
 168 168 168 105 105 168 105 127 128 129 130 131 132 133 134 135 136 137 138 139 140 141 142 143 144 145 146 147 189 189 167 167 167 101 102 235 148 148 148 148 301 301 301  73  73  73  73  73 376 376 376 376 104 104 104 104 104 401 401 401 401 401 401 401 401 401 401 401 401 401 401 401 401 401 401 401 401 401 401 401 401 401 401 401 401 401 401 401 401 401
 168 168 105 105 105 168 149 149 149 150 151 152 153 154 155 156 157 158 159 160 161 162 163 164 165 187 187 166 189 189 167 167 167 235 235 235 148 148 148 148 301 301 258  73  73  73  73 376 376 376 376 376 104 104 104 104 104 376 376 401 401 401 401 401 401 401 401 401 401 401 401 401 401 401 401 401 401 401 401 401 401 401 401 401 401 401 401 401 401 401
 168 168 168 105 105 168 168 149 169 170 171 172 173 174 175 176 177 178 179 180 181 182 183 184 185 186 187 188 188 189 190 191 167 235 235 235 235 235 148 301 301 301 258  73  73  73  73 376 376 376 376 376 104 104 104 104 104 376 376 376 401 401 401 401 401 401 401 401 401 401 401 401 401 401 401 401 401 401 401 401 401 401 401 401 401 401 401 401 401 401
 168 168 168 168 168 168 168 149 192 193 194 195 196 197 198 199 200 201 202 203 204 205 206 207 208 209 210 211 212 189 191 191 235 235 235 235 235 300 300 301 301 301 258  73  73  73  73 376 376 376 376 376 376 104 104 104 376 376 376 376 376 376 401 401 401 401 401 401 401 401 401 401 401 401 401 401 401 401 401 401 401 401 401 401 401 401 401 401 401 401
 168 168 168 168 168 168 168 213 213 193 214 215 216 217 218 219 220 221 222 223 224 225 226 227 228 229 230 231 212 232 233 191 234 235 235 235 235 300 300 301 301 301 258 258  73  73  73 376 376 376 376 376 376 104 104 104 104 376 376 376 376 376 376 401 401 401 401 401 401 401 401 401 401 401 401 401 401 401 401 401 401 401 401 401 401 401 401 401 401 401
 168 168 168 168 168 168 168 213 213 236 237 238 239 240 241 242 243 244 245 246 247 248 249 250 251 252 253 254 255 278 256 257 234 235 235 235 300 300 301 301 301 301 258 258 361  73  73 376 376 376 376 376 376 104 104 104 104 376 376 376 376 376 376 376 376 401 401 401 401 401 401 401 401 401 401 401 401 401 401 401 401 401 401 401 401 401 401 401 401 401
 168 168 168 168 168 168 377 377 377 377 259 260 261 262 263 264 265 266 267 268 269 270 271 272 273 274 275 276 277 278 279 298 280 280 280 300 300 300 301 301 301 301 258 361 361  73  73 376 376 376 376 376 376 376 104 104 376 376 376 376 376 376 376 376 401 401 401 401 401 401 401 401 401 401 401 401 401 401 401 401 401 401 401 401 401 401 401 401 401 401
 168 168 168 168 168 377 377 377 377 324 302 281 261 282 263 283 284 285 286 287 288 289 290 291 292 293 294 316 295 296 297 298 280 299 280 300 300 300 301 301 301 301 258 361 361  73  73  73  73 376 376 323 376 376 376 376 376 376 376 376 376 376 376 376 401 401 401 401 401 401 401 401 401 401 401 401 401 401 401 401 401 401 401 401 401 401 401 401 401 401
 168 168 168 168 168 168 377 377 377 324 302 302 303 282 304 305 306 307 308 309 310 311 312 313 292 314 315 316 317 318 319 320 321 343 343 322 322 300 301 301 301 301 361 361 361  73  73  73  73 323 323 323 376 376 376 376 376 376 376 376 376 376 376 376 401 401 401 401 401 401 401 401 401 401 401 401 401 401 401 401 401 401 401 401 401 401 401 401 401 401
 168 168 168 168 168 377 377 377 324 324 325 325 326 282 327 328 329 307 330 309 331 332 312 333 334 335 336 337 338 339 340 320 341 342 343 360 360 300 301 301 301 301 361 361 361  73  73  73 323 323 323 323 376 376 376 376 376 376 376 376 376 376 376 401 401 401 401 401 401 401 401 401 401 401 401 401 401 401 401 401 401 401 401 401 401 401 401 401 401 401
 168 168 168 168 168 168 377 377 324 324 325 325 398 282 344 345 346 347 348 349 350 351 352 353 334 354 355 338 338 356 357 358 359 359 343 360 360 300 301 387 387 387 361 361 361  73  73 323 323 323 323 323 376 376 376 376 376 376 376 376 401 376 401 401 401 401 401 401 401 401 401 401 401 401 401 401 401 401 401 401 401 401 401 401 401 401 401 401 401 401
 168 168 168 168 168 168 168 377 377 396 396 396 398 362 344 346 346 411 363 364 365 366 367 368 369 370 355 371 338 372 357 373 374 394 375 375 360 386 387 387 387 387 361 361 361  73  73 323 323 323 323 323 323 376 376 376 376 376 376 376 401 401 401 401 401 401 401 401 401 401 401 401 401 401 401 401 401 401 401 401 401 401 401 401 401 401 401 401 401 401
 168 168 168 168 168 168 377 377 377 396 396 396 398 362 346 346 346 411 378 378 378 379 380 381 381 382 383 384 385 385 357 394 394 394 394 386 386 386 387 387 387 387 361 361 361  73  73 323 323 323 323 323 376 376 376 376 376 376 376 401 401 401 401 401 401 401 401 401 401 401 401 401 401 401 401 401 401 401 401 401 401 401 401 401 401 401 401 401 401 401
 168 168 168 168 168 168 168 377 377 396 396 396 398 398 398 398 388 411 389 389 378 390 380 403 403 403 391 392 385 385 393 394 394 394 394 395 395 386 387 387 387 387 361 361 361  73  73 323 323 323 323 323 323 376 376 376 376 421 376 421 401 401 401 401 401 401 401 401 401 401 401 401 401 401 401 401 401 401 401 401 401 401 401 401 401 401 401 401 401 401
 168 168 168 168 168 168 168 377 377 377 396 396 397 397 398 398 388 411 411 408 378 403 403 403 403 403 399 410 385 400 413 394 413 394 394 407 395 386 387 387 387 418 361 361 361 323 323 323 323 323 323 323 323 376 376 376 376 421 421 421 421 401 401 401 401 401 401 401 401 401 401 401 401 401 401 401 401 401 401 401 401 401 401 401 401 401 401 401 401 401
 168 168 168 168 168 168 377 377 377 377 396 396 397 398 398 411 411 411 411 408 409 409 403 402 403 403 410 410 404 405 413 413 413 406 407 407 395 386 387 387 418 418 418 361 361 419 323 323 323 323 323 323 323 376 376 376 376 421 421 421 421 421 401 401 401 401 401 401 401 401 401 401 401 401 401 401 401 401 401 401 401 401 401 401 401 401 401 401 401 401
 168 168 168 168 168 168 168 377 377 377 396 396 397 411 411 411 411 411 411 408 408 409 409 409 403 403 410 410 412 405 413 413 413 406 407 407 386 386 387 418 418 418 418 361 361 419 323 323 323 323 323 323 323 376 376 376 376 376 421 421 421 421 414 401 401 401 401 401 401 401 401 401 401 401 401 401 401 401 401 401 401 401 401 401 401 401 401 401 401 401
 168 168 168 168 168 168 168 377 377 397 397 397 397 411 411 411 411 411 411 409 409 409 409 409 409 403 412 412 412 422 422 413 413 406 407 407 386 417 387 418 418 418 418 422 422 419 323 323 323 422 323 323 323 376 376 376 376 421 421 421 421 414 414 414 401 401 401 401 401 401 401 401 401 401 401 401 401 401 401 401 401 401 401 401 401 401 401 401 401 401
 168 168 168 168 168 168 377 377 377 397 397 397 397 397 397 411 411 411 411 409 409 409 409 409 409 403 403 412 412 422 422 413 422 416 416 407 417 417 417 418 418 418 418 422 422 419 419 422 422 422 323 323 323 376 376 421 421 421 421 421 421 421 414 414 401 401 401 401 401 401 401 401 401 401 401 401 401 401 401 401 401 401 401 401 401 401 401 401 401 401
 168 168 168 168 168 377 377 377 377 377 397 397 397 397 397 411 411 411 411 409 409 409 415 415 409 409 412 412 412 422 422 422 422 416 416 422 417 417 417 418 418 418 418 422 422 422 419 422 422 422 323 376 376 376 376 376 421 421 421 421 421 421 421 414 401 401 401 401 401 401 401 401 401 401 401 401 401 401 401 401 401 401 401 401 401 401 401 401 401 401
 168 168 168 168 377 377 377 377 377 377 377 377 377 377 397 411 411 411 411 409 409 420 415 415 409 409 422 422 422 422 422 422 422 416 416 422 417 417 417 418 418 418 418 418 422 422 422 422 422 323 323 376 376 376 376 376 421 421 421 421 421 421 414 414 414 401 401 401 401 401 401 401 401 401 401 401 401 401 401 401 401 401 401 401 401 401 401 401 401 401
 168 168 168 377 377 377 377 377 377 377 377 377 377 377 397 411 411 411 411 409 409 420 415 415 409 422 422 422 422 422 422 422 422 422 416 422 417 417 417 418 418 418 418 418 422 422 422 422 422 323 376 376 376 376 376 376 421 421 421 421 421 414 414 414 414 414 401 401 401 401 401 401 401 401 401 401 401 401 401 401 401 401 401 401 401 401 401 401 401 401
 168 168 168 168 377 377 377 377 377 377 377 377 377 377 397 397 411 411 411 420 420 420 415 415 415 415 422 422 422 422 422 422 422 422 422 422 422 417 417 418 418 418 418 418 422 422 422 422 422 376 376 376 376 376 376 376 376 421 421 421 421 414 414 414 414 401 401 401 401 401 401 401 401 401 401 401 401 401 401 401 401 401 401 401 401 401 401 401 401 401
 168 168 168 168 168 377 377 377 377 377 377 377 377 397 397 397 397 397 420 420 420 420 415 415 415 415 422 422 422 422 422 422 422 422 422 422 422 417 418 418 418 418 418 418 422 422 422 422 422 376 376 376 376 376 376 376 421 421 421 421 414 414 414 414 401 401 401 401 401 401 401 401 401 401 401 401 401 401 401 401 401 401 401 401 401 401 401 401 401 401
 168 168 168 168 168 168 377 377 377 377 168 168 377 397 397 397 397 420 420 420 420 420 420 420 415 415 415 422 422 422 422 422 422 422 422 422 422 417 418 418 418 418 418 418 422 422 422 422 422 376 376 376 376 376 376 376 421 421 421 421 414 414 401 401 401 401 401 401 401 401 401 401 401 401 401 401 401 401 401 401 401 401 401 401 401 401 401 401 401 401
 168 168 168 168 168 168 168 377 168 168 168 420 420 420 420 397 397 397 420 420 420 420 420 420 415 415 422 422 422 422 422 422 422 422 422 422 422 417 418 418 418 418 422 422 422 422 422 422 422 376 376 376 376 376 376 376 421 421 421 414 414 414 401 414 401 401 401 401 401 401 401 401 401 401 401 401 401 401 401 401 401 401 401 401 401 401 401 401 401 401
 168 168 168 168 168 168 168 168 168 168 420 420 420 420 420 420 397 397 397 420 420 420 420 420 422 422 422 422 422 422 422 422 422 422 422 422 418 417 418 418 418 418 418 422 422 422 422 422 422 422 414 376 376 376 376 421 421 421 421 414 414 414 414 414 414 401 401 401 401 401 401 401 401 401 401 401 401 401 401 401 401 401 401 401 401 401 401 401 401 401
 168 168 168 168 168 168 168 168 168 420 420 420 420 420 420 420 420 397 420 420 420 420 420 420 422 422 422 422 422 422 422 422 422 422 422 418 418 418 418 418 418 418 422 422 422 422 422 422 422 414 414 414 376 376 376 421 421 414 414 414 414 414 414 414 414 414 401 401 401 401 401 401 401 401 401 401 401 401 401 401 401 401 401 401 401 401 401 401 401 401
 168 168 168 168 168 168 168 168 420 420 420 420 420 420 420 420 420 420 420 420 420 420 420 420 420 420 422 422 422 422 422 422 422 422 422 422 418 418 418 418 418 418 422 422 422 422 422 422 422 414 414 376 376 376 421 421 414 414 414 414 414 414 414 414 414 414 414 401 401 401 401 401 401 401 401 401 401 401 401 401 401 401 401 401 401 401 401 401 401 401
 168 168 168 168 168 168 168 420 420 420 420 420 420 420 420 420 420 168 420 420 420 420 420 420 420 422 422 422 422 422 422 422 422 422 422 418 418 418 422 422 418 418 418 422 422 422 422 422 414 414 414 414 376 421 421 414 414 414 414 414 414 414 414 414 414 414 401 401 401 401 401 401 401 401 401 401 401 401 401 401 401 401 401 401 401 401 401 401 401 401
 168 168 168 168 168 168 168 168 420 420 420 420 420 420 420 420 420 168 168 420 420 420 420 420 420 168 422 422 422 422 422 422 422 422 422 422 418 422 422 422 422 418 422 422 422 422 422 422 414 414 414 414 421 421 421 421 414 414 414 414 414 414 414 414 414 401 401 401 401 401 401 401 401 401 401 401 401 401 401 401 401 401 401 401 401 401 401 401 401 401
 168 168 168 168 168 168 168 168 168 420 420 420 420 420 420 420 168 168 168 168 420 168 168 420 168 168 422 422 422 422 422 422 422 422 422 422 422 422 422 422 422 422 422 422 422 422 422 422 422 414 414 414 414 421 421 414 414 414 414 414 414 414 414 414 401 401 401 401 401 401 401 401 401 401 401 401 401 401 401 401 401 401 401 401 401 401 401 401 401 401
 168 168 168 168 168 168 168 168 168 168 420 420 420 168 420 168 168 168 168 168 168 168 168 168 168 422 422 422 422 422 422 422 422 422 422 422 422 422 422 422 422 422 422 422 422 422 422 422 414 414 414 414 414 414 414 414 414 414 414 414 414 414 414 414 401 401 401 401 401 401 401 401 401 401 401 401 401 401 401 401 401 401 401 401 401 401 401 401 401 401
 168 168 168 168 168 168 168 168 168 168 168 420 168 168 168 168 168 168 168 168 168 168 168 168 422 422 422 422 422 422 422 422 422 422 422 422 422 422 422 422 422 422 422 422 422 422 422 422 414 414 414 414 414 414 414 414 414 414 414 414 414 414 414 401 401 401 401 401 401 401 401 401 401 401 401 401 401 401 401 401 401 401 401 401 401 401 401 401 401 401
 168 168 168 168 168 168 168 168 168 168 168 168 168 168 168 168 168 168 168 168 168 168 168 422 422 422 422 422 422 422 422 422 422 422 422 422 422 422 422 422 422 422 422 422 422 422 422 422 422 414 414 414 414 414 414 414 414 401 401 414 414 414 401 401 401 401 401 401 401 401 401 401 401 401 401 401 401 401 401 401 401 401 401 401 401 401 401 401 401 401
 168 168 168 168 168 168 168 168 168 168 168 168 168 168 168 168 168 168 168 168 168 168 422 422 422 422 422 422 422 422 422 422 422 422 422 422 422 422 422 422 422 422 422 422 422 422 422 422 414 414 414 414 414 401 401 414 401 401 401 401 414 401 401 401 401 401 401 401 401 401 401 401 401 401 401 401 401 401 401 401 401 401 401 401 401 401 401 401 401 401
 168 168 168 168 168 168 168 168 168 168 168 168 168 168 168 168 168 168 168 168 168 422 422 422 422 422 422 422 422 422 422 422 422 422 422 422 422 422 422 422 422 422 422 422 422 422 422 414 414 414 414 414 414 414 401 401 401 401 401 401 401 401 401 401 401 401 401 401 401 401 401 401 401 401 401 401 401 401 401 401 401 401 401 401 401 401 401 401 401 401
 168 168 168 168 168 168 168 168 168 168 168 168 168 168 168 168 168 168 168 168 422 422 422 422 422 422 422 422 422 422 422 422 422 422 422 422 422 422 422 422 422 422 422 422 422 422 414 414 414 414 414 414 414 401 401 401 401 401 401 401 401 401 401 401 401 401 401 401 401 401 401 401 401 401 401 401 401 401 401 401 401 401 401 401 401 401 401 401 401 401
 168 168 168 168 168 168 168 168 168 168 168 168 168 168 168 168 168 168 168 168 168 422 422 422 422 422 422 422 422 422 422 422 422 422 422 422 422 422 422 422 422 422 422 422 422 414 414 414 414 414 414 414 401 401 401 401 401 401 401 401 401 401 401 401 401 401 401 401 401 401 401 401 401 401 401 401 401 401 401 401 401 401 401 401 401 401 401 401 401 401
