  89  89  89  89  89  89   1   4   4   4   4   7   7   7   8   9   9  11  11  13  16  16  16  16  16  16  16  16  41  41  41  41  41  41  41  88  88  88  88  42  42  42  42  42  42  42  42  42  42  42  42 179 179 179 179 179 179 179 179 179 179 179 179 179 179 179 179 179 179 179 179 179 179 179 179 179 179 179 179 179 179 179 179 179 179 179 179 179 179 179
  89  89  89  89  89  89   1   4   4   4   4   7   7   7   8   9   9  11  12  13  16  16  16  16  16  16  16  16  41  40  40  41  41  41  41  88  88  88  88  88  42  42  42  42  42  42  42  42  42  42  42  42 179 179 179 179 179 179 179 179 179 179 179 179 179 179 179 179 179 179 179 179 179 179 179 179 179 179 179 179 179 179 179 179 179 179 179 179 179 179
  89  89  89  89  89  89   1   2   4   3   4   5   6   7   8   9  10  11  12  13  14  15  16  16  16  16  37  16  41  40  40  41  41  41  41  88  88  88  88  88  42  42  42  42  42  42  42  42  42  42  42  42 179 179 179 179 179 179 179 179 179 179 179 179 179 179 179 179 179 179 179 179 179 179 179 179 179 179 179 179 179 179 179 179 179 179 179 179 179 179
  89  89  89  89  17  17  17  18  19  20  21  22  23  24  25  26  27  28  29  30  31  32  33  34  35  36  37  38 116  39  40 103 103  41  41  88  88  88  88  88 171  42  42  42  42  42  42  42  42 179  42  42 179 179 179 179 179 179 179 179 179 179 179 179 179 179 179 179 179 179 179 179 179 179 179 179 179 179 179 179 179 179 179 179 179 179 179 179 179 179
  89  89  89  89  89  89  89  43  44  45  46  47  48  49  50  51  52  53  54  55  56  57  58  59  60  61  37 116 116 116 103 103 103 139 139  88  88  88  88  88 171  42  42  42  42  42  42  42  42 179 179 179 179 179 179 179 179 179 179 179 179 179 179 179 179 179 179 179 179 179 179 179 179 179 179 179 179 179 179 179 179 179 179 179 179 179 179 179 179 179
  89  89  89  89  89  89  89  62  89  63  64  65  66  67  68  69  70  71  72  73  56  74  75  61  61  61 115 116 116 116 103 103 103 139 139  88  88  88  88  88 171  42  42  42  42  42  42  42  42 179 179 179 179 179 179 179 179 179 179 179 179 179 179 179 179 179 179 179 179 179 179 179 179 179 179 179 179 179 179 179 179 179 179 179 179 179 179 179 179 179
  89  89  89  89  89  89  89  89  89  63  76  77  78  79  80  81  82  83  84  85  86  87  75 102 115 115 115 116 116 116 103 103 103 139 139 139  88  88  88  88 171 171 171  42  42  42  42  42 179 179 179 179 179 179 179 179 179 179 179 179 179 179 179 179 179 179 179 179 179 179 179 179 179 179 179 179 179 179 179 179 179 179 179 179 179 179 179 179 179 179
  89  89  89  89  89  89  89  89  89  90  91  92  93  94  95  96  97  98  99 113 100 101 126 102 115 115 115 116 116 116 103 103 103 139 139 139  88  88  88  88 171 171 171  42  42  42  42 179 179 179 179 179 179 179 179 179 179 179 179 179 179 179 179 179 179 179 179 179 179 179 179 179 179 179 179 179 179 179 179 179 179 179 179 179 179 179 179 179 179 179
  89  89  89  89  89  89  89  89  89 104 105 106 107 108 109 110 111 112 113 113 114 126 126 127 127 115 115 116 116 116 103 103 103 139 139 139 139 139  88 171 171 171 171  42  42  42  42 179 179 179 179 179 179 179 179 179 179 179 179 179 179 179 179 179 179 179 179 179 179 179 179 179 179 179 179 179 179 179 179 179 179 179 179 179 179 179 179 179 179 179
  89  89  89  89  89  89  89  89  89  89 128 128 128 117 118 119 120 121 122 123 124 125 126 127 127 115 116 116 116 116 103 103 139 139 139 139 139 171 171 171 171 171 171  42  42  42  42 179 179 179 179 179 179 179 179 179 179 179 179 179 179 179 179 179 179 179 179 179 179 179 179 179 179 179 179 179 179 179 179 179 179 179 179 179 179 179 179 179 179 179
  89  89  89  89  89  89  89  89  89  89 128 128 128 129 141 130 131 132 133 134 135 136 126 137 127 138 116 116 116 116 170 103 139 139 139 139 139 171 171 171 171 171 171 171  42  42  42 179 179 179 179 179 179 179 179 179 179 179 179 179 179 179 179 179 179 179 179 179 179 179 179 179 179 179 179 179 179 179 179 179 179 179 179 179 179 179 179 179 179 179
  89  89  89  89  89  89  89  89  89  89 128 128 140 141 141 142 143 144 145 146 147 147 148 149 150 138 116 159 116 160 170 170 139 139 139 139 171 171 171 171 171 171 171 171 189  42  42 179 179 179 179 179 179 179 179 179 179 179 179 179 179 179 179 179 179 179 179 179 179 179 179 179 179 179 179 179 179 179 179 179 179 179 179 179 179 179 179 179 179 179
  89  89  89  89  89  89 189 189 189 189 128 128 128 151 142 142 152 153 154 146 155 156 157 149 158 116 116 159 160 160 170 170 171 171 171 171 171 171 171 171 171 171 171 189 189  42  42 179 179 179 179 179 179 179 179 179 179 179 179 179 179 179 179 179 179 179 179 179 179 179 179 179 179 179 179 179 179 179 179 179 179 179 179 179 179 179 179 179 179 179
  89  89  89  89  89 189 189 189 189 185 128 128 128 161 142 162 163 153 164 165 166 167 168 169 175 116 116 160 160 170 170 170 171 177 171 171 171 171 171 171 171 171 171 189 189  42  42  42  42 179 179 174 179 179 179 179 179 179 179 179 179 179 179 179 179 179 179 179 179 179 179 179 179 179 179 179 179 179 179 179 179 179 179 179 179 179 179 179 179 179
  89  89  89  89  89 189 189 189 189 185 128 128 128 161 178 153 153 153 172 172 166 172 172 173 175 186 160 160 170 170 170 170 177 177 177 171 171 171 171 171 171 171 189 189 189  42  42  42  42 174 174 174 179 179 179 179 179 179 179 179 179 179 179 179 179 179 179 179 179 179 179 179 179 179 179 179 179 179 179 179 179 179 179 179 179 179 179 179 179 179
  89  89  89  89 189 189 189 189 185 185 185 185 161 161 178 178 178 153 180 172 172 172 172 175 175 186 176 176 176 170 170 170 184 184 177 171 171 171 171 171 171 171 189 189 189  42  42  42 174 174 174 174 179 179 179 179 179 179 179 179 179 179 179 179 179 179 179 179 179 179 179 179 179 179 179 179 179 179 179 179 179 179 179 179 179 179 179 179 179 179
  89  89  89  89  89 189 189 189 185 185 185 185 185 161 178 178 178 153 180 172 180 186 172 175 175 186 176 176 176 189 189 170 184 184 177 171 171 171 171 183 183 183 189 189 189  42  42 174 174 174 174 174 179 179 179 179 179 179 179 179 179 179 179 179 179 179 179 179 179 179 179 179 179 179 179 179 179 179 179 179 179 179 179 179 179 179 179 179 179 179
  89  89  89  89  89  89 189 189 189 188 188 188 185 178 178 178 178 188 180 180 180 186 186 175 186 186 176 176 176 189 189 184 184 184 184 184 171 182 183 183 183 183 189 189 189  42  42 174 174 174 174 174 174 179 179 179 179 179 179 179 179 179 179 179 179 179 179 179 179 179 179 179 179 179 179 179 179 179 179 179 179 179 179 179 179 179 179 179 179 179
  89  89  89  89  89 189 189 189 189 188 188 188 185 178 178 178 178 188 180 180 180 186 186 175 175 186 176 181 181 181 189 184 184 184 184 182 182 182 183 183 183 183 189 189 189  42  42 174 174 174 174 174 179 179 179 179 179 179 179 179 179 179 179 179 179 179 179 179 179 179 179 179 179 179 179 179 179 179 179 179 179 179 179 179 179 179 179 179 179 179
  89  89  89  89  89  89 189 189 189 188 188 188 185 185 185 185 178 188 180 180 180 186 186 186 186 186 187 181 181 181 189 184 184 184 184 182 182 182 183 183 183 183 189 189 189  42  42 174 174 174 174 174 174 179 179 179 179 179 179 179 179 179 179 179 179 179 179 179 179 179 179 179 179 179 179 179 179 179 179 179 179 179 179 179 179 179 179 179 179 179
  89  89  89  89  89  89 189 189 189 189 188 188 188 188 185 185 178 188 188 180 180 186 186 186 186 186 187 187 181 189 189 184 189 184 184 189 182 182 183 183 183 189 189 189 189 174 174 174 174 174 174 174 174 179 179 179 179 179 179 179 179 179 179 179 179 179 179 179 179 179 179 179 179 179 179 179 179 179 179 179 179 179 179 179 179 179 179 179 179 179
  89  89  89  89  89 189 189 189 189 189 188 188 188 185 185 188 188 188 188 180 189 189 186 186 186 186 187 187 189 189 189 189 189 189 189 189 182 182 183 183 189 189 189 189 189 189 174 174 174 174 174 174 174 179 179 179 179 179 179 179 179 179 179 179 179 179 179 179 179 179 179 179 179 179 179 179 179 179 179 179 179 179 179 179 179 179 179 179 179 179
  89  89  89  89  89  89 189 189 189 189 188 188 188 188 188 188 188 188 188 180 180 189 189 189 186 186 187 187 189 189 189 189 189 189 189 189 182 182 183 189 189 189 189 189 189 189 174 174 174 174 174 174 174 179 179 179 179 179 179 179 179 179 189 179 179 179 179 179 179 179 179 179 179 179 179 179 179 179 179 179 179 179 179 179 179 179 179 179 179 179
  89  89  89  89  89  89 189 189 189 189 188 188 188 188 188 188 188 188 188 189 189 189 189 189 189 186 189 189 189 189 189 189 189 189 189 189 182 189 183 189 189 189 189 189 189 189 174 174 174 189 174 174 174 179 179 179 179 179 179 179 179 189 189 189 179 179 179 179 179 179 179 179 179 179 179 179 179 179 179 179 179 179 179 179 179 179 179 179 179 179
  89  89  89  89  89 189 189 189 189 189 188 188 188 188 188 188 188 188 188 189 189 189 189 189 189 186 186 189 189 189 189 189 189 189 189 189 189 189 189 189 189 189 189 189 189 189 189 189 189 189 174 174 174 179 179 179 179 179 179 179 179 179 189 189 179 179 179 179 179 179 179 179 179 179 179 179 179 179 179 179 179 179 179 179 179 179 179 179 179 179
  89  89  89  89 189 189 189 189 189 189 189 188 188 188 188 188 188 188 188 189 189 189 189 189 189 189 189 189 189 189 189 189 189 189 189 189 189 189 189 189 189 189 189 189 189 189 189 189 189 189 174 179 179 179 179 179 179 179 179 179 179 179 179 189 179 179 179 179 179 179 179 179 179 179 179 179 179 179 179 179 179 179 179 179 179 179 179 179 179 179
  89  89  89 189 189 189 189 189 189 189 189 189 189 189 188 188 188 188 188 189 189 189 189 189 189 189 189 189 189 189 189 189 189 189 189 189 189 189 189 189 189 189 189 189 189 189 189 189 189 174 174 179 179 179 179 179 179 179 179 179 179 179 189 189 189 179 179 179 179 179 179 179 179 179 179 179 179 179 179 179 179 179 179 179 179 179 179 179 179 179
  89  89 189 189 189 189 189 189 189 189 189 189 189 189 188 188 188 188 188 189 189 189 189 189 189 189 189 189 189 189 189 189 189 189 189 189 189 189 189 189 189 189 189 189 189 189 189 189 189 174 179 179 179 179 179 179 179 179 179 179 179 189 189 189 189 189 179 179 179 179 179 179 179 179 179 179 179 179 179 179 179 179 179 179 179 179 179 179 179 179
  89  89  89 189 189 189 189 189 189 189 189 189 189 189 188 188 188 188 188 189 189 189 189 189 189 189 189 189 189 189 189 189 189 189 189 189 189 189 189 189 189 189 189 189 189 189 189 189 189 179 179 179 179 179 179 179 179 179 179 179 179 189 189 189 189 179 179 179 179 179 179 179 179 179 179 179 179 179 179 179 179 179 179 179 179 179 179 179 179 179
  89  89  89  89 189 189 189 189 189 189 189 189 189 188 188 188 188 189 189 189 189 189 189 189 189 189 189 189 189 189 189 189 189 189 189 189 189 189 189 189 189 189 189 189 189 189 189 189 189 179 179 179 179 179 179 179 179 179 179 179 189 189 189 189 189 179 179 179 179 179 179 179 179 179 179 179 179 179 179 179 179 179 179 179 179 179 179 179 179 179
  89  89  89  89  89 189 189 189 189 189 189 189 189 188 188 188 188 189 189 189 189 189 189 189 189 189 189 189 189 189 189 189 189 189 189 189 189 189 189 189 189 189 189 189 189 189 189 189 189 179 179 179 179 179 179 179 179 179 179 179 189 189 189 189 179 179 179 179 179 179 179 179 179 179 179 179 179 179 179 179 179 179 179 179 179 179 179 179 179 179
  89  89  89  89  89  89 189 189 189 189 189 189 189 189 189 188 188 189 189 189 189 189 189 189 189 189 189 189 189 189 189 189 189 189 189 189 189 189 189 189 189 189 189 189 189 189 189 189 189 179 179 179 179 179 179 179 179 179 179 189 189 189 189 189 189 179 179 179 179 179 179 179 179 179 179 179 179 179 179 179 179 179 179 179 179 179 179 179 179 179
  89  89  89  89  89  89  89 189 189 189 189 189 189 189 189 189 189 189 189 189 189 189 189 189 189 189 189 189 189 189 189 189 189 189 189 189 189 189 189 189 189 189 189 189 189 189 189 189 189 189 179 179 179 179 179 179 179 179 189 189 189 189 189 189 189 189 179 179 179 179 179 179 179 179 179 179 179 179 179 179 179 179 179 179 179 179 179 179 179 179
  89  89  89  89  89  89  89  89 189 189 189 189 189 189 189 189 189 189 189 189 189 189 189 189 189 189 189 189 189 189 189 189 189 189 189 189 189 189 189 189 189 189 189 189 189 189 189 189 189 179 179 179 179 179 179 179 179 189 189 189 189 189 189 189 189 189 189 179 179 179 179 179 179 179 179 179 179 179 179 179 179 179 179 179 179 179 179 179 179 179
  89  89  89  89  89  89  89 189 189 189 189 189 189 189 189 189 189 189 189 189 189 189 189 189 189 189 189 189 189 189 189 189 189 189 189 189 189 189 189 189 189 189 189 189 189 189 189 189 189 179 179 179 179 179 179 189 189 189 189 189 189 189 189 189 189 189 189 179 179 179 179 179 179 179 179 179 179 179 179 179 179 179 179 179 179 179 179 179 179 179
  89  89  89  89  89  89 189 189 189 189 189 189 189 189 189 189 189 189 189 189 189 189 189 189 189 189 189 189 189 189 189 189 189 189 189 189 189 189 189 189 189 189 189 189 189 189 189 189 179 179 179 189 179 179 189 189 189 189 189 189 189 189 189 189 189 189 179 179 179 179 179 179 179 179 179 179 179 179 179 179 179 179 179 179 179 179 179 179 179 179
  89  89  89  89  89  89  89 189 189 189 189 189 189 189 189 189 189 189 189 189 189 189 189 189 189 189 189 189 189 189 189 189 189 189 189 189 189 189 189 189 189 189 189 189 189 189 189 189 179 179 189 189 189 179 179 189 189 189 189 189 189 189 189 189 189 189 179 179 179 179 179 179 179 179 179 179 179 179 179 179 179 179 179 179 179 179 179 179 179 179
  89  89  89  89  89  89  89  89 189 189 189 189 189 189 189 189 189  89  89 189 189 189 189 189 189 189 189 189 189 189 189 189 189 189 189 189 189 189 189 189 189 189 189 189 189 189 189 189 189 189 189 189 189 189 189 189 189 189 189 189 189 189 189 189 189 179 179 179 179 179 179 179 179 179 179 179 179 179 179 179 179 179 179 179 179 179 179 179 179 179
  89  89  89  89  89  89  89  89  89 189 189 189 189 189 189 189  89  89  89  89 189  89  89 189 189 189 189 189 189 189 189 189 189 189 189 189 189 189 189 189 189 189 189 189 189 189 189 189 189 189 189 189 189 189 189 189 189 189 189 189 189 189 189 189 189 179 179 179 179 179 179 179 179 179 179 179 179 179 179 179 179 179 179 179 179 179 179 179 179 179
  89  89  89  89  89  89  89  89  89  89 189 189 189  89 189  89  89  89  89  89  89  89  89  89 189 189 189 189 189 189 189 189 189 189 189 189 189 189 189 189 189 189 189 189 189 189 189 189 189 189 189 189 189 189 189 189 189 189 189 189 189 189 189 189 179 179 179 179 179 179 179 179 179 179 179 179 179 179 179 179 179 179 179 179 179 179 179 179 179 179
  89  89  89  89  89  89  89  89  89  89  89 189  89  89  89  89  89  89  89  89  89  89  89 189 189 189 189 189 189 189 189 189 189 189 189 189 189 189 189 189 189 189 189 189 189 189 189 189 189 189 189 189 189 189 189 189 189 189 189 189 189 189 189 179 179 179 179 179 179 179 179 179 179 179 179 179 179 179 179 179 179 179 179 179 179 179 179 179 179 179
  89  89  89  89  89  89  89  89  89  89  89  89  89  89  89  89  89  89  89  89  89  89 189 189 189 189 189 189 189 189 189 189 189 189 189 189 189 189 189 189 189 189 189 189 189 189 189 189 189 189 189 189 189 189 189 189 189 179 179 189 189 189 179 179 179 179 179 179 179 179 179 179 179 179 179 179 179 179 179 179 179 179 179 179 179 179 179 179 179 179
  89  89  89  89  89  89  89  89  89  89  89  89  89  89  89  89  89  89  89  89  89 189 189 189 189 189 189 189 189 189 189 189 189 189 189 189 189 189 189 189 189 189 189 189 189 189 189 189 189 189 189 189 189 189 189 189 179 179 179 179 189 179 179 179 179 179 179 179 179 179 179 179 179 179 179 179 179 179 179 179 179 179 179 179 179 179 179 179 179 179
  89  89  89  89  89  89  89  89  89  89  89  89  89  89  89  89  89  89  89  89 189 189 189 189 189 189 189 189 189 189 189 189 189 189 189 189 189 189 189 189 189 189 189 189 189 189 189 189 189 189 189 189 189 189 179 179 179 179 179 179 179 179 179 179 179 179 179 179 179 179 179 179 179 179 179 179 179 179 179 179 179 179 179 179 179 179 179 179 179 179
  89  89  89  89  89  89  89  89  89  89  89  89  89  89  89  89  89  89  89  89  89 189 189 189 189 189 189 189 189 189 189 189 189 189 189 189 189 189 189 189 189 189 189 189 189 189 189 189 189 189 189 189 189 179 179 179 179 179 179 179 179 179 179 179 179 179 179 179 179 179 179 179 179 179 179 179 179 179 179 179 179 179 179 179 179 179 179 179 179 179
