  56  56  56   7   7   8   1   3   3   3   3   4   5  17   6   6  19  19  19  22  22  24  24  26  47  27  52  52  52  52  54  54  54  54  54  54  54  54  54  54  54  54  55  55  55  55  55  55  55  55  55  55  55  55  55  55  55  55  55  55 224 224 224 224 224 224 224 224 224 224 224 224 224 224 224 224 224 224 224 224 224 224 224 224 224 224 224 224 224 224
  56  56  56   7   7   8   1   3   2   3   3   4   5  17  17   6  19  19  21  22  22  24  24  26  47  27  52  52  52  52  54  54  54  54  54  54  54  54  54  54  54  55  55  55  55  55  55  55  55  55  55  55  55  55  55  55  55  55  55 224 224 224 224 224 224 224 224 224 224 224 224 224 224 224 224 224 224 224 224 224 224 224 224 224 224 224 224 224 224 224
  56  56  56   7   7   8   9  10  11  12  13  14  15  16  17  18  19  20  21  22  23  24  25  26  47  27  50  50  51  52  53  54 126 126  54  54  54  54  54  54  55  55  55  55  55  55  55  55  55  55  55  55  55  55  55  55  55  55 224 224 224 224 224 224 224 224 224 224 224 224 224 224 224 224 224 224 224 224 224 224 224 224 224 224 224 224 224 224 224 224
  56  56  56 142   7  28  29  30  31  32  33  34  35  36  37  38  39  40  41  42  43  44  45  46  47  48  49  50  51  52  53 172 126 126  54  54  54  54 213  54  55  55  55  55  55  55  55  55  55  55  55  55  55  55  55  55  55  55  55 224 224 224 224 224 224 224 224 224 224 224 224 224 224 224 224 224 224 224 224 224 224 224 224 224 224 224 224 224 224 224
  56  56  56 142  78  78  57  58  59  60  61  62  63  64  65  66  67  68  69  70  71  72  73  74  75  76  77  52  52  52 172 172 126 126 126  54  54  54 213 213 213 213 213 213 213  55  55  55  55  55  55  55  55  55  55  55  55  55  55 224 224 224 224 224 224 224 224 224 224 224 224 224 224 224 224 224 224 224 224 224 224 224 224 224 224 224 224 224 224 224
  56  56  56 142  78  78  78  79  80  81  82  83  84  85  86  87  88  89  90  91  92  93  73 125 125 109 109 109  52  52 172 172 126 126 126 126  54  54 213 213 213 213 213 213 213  55  55  55  55  55  55  55  55  55  55  55  55  55 224 224 224 224 224 224 224 224 224 224 224 224 224 224 224 224 224 224 224 224 224 224 224 224 224 224 224 224 224 224 224 224
  56  56  56 142 142 142  78  94  95  96  97  98  99 100 101 102 103 104 105 106 107 123 108 125 125 125 109 109 172 172 172 172 172 126 126 126 213 213 213 213 213 213 213 213  55  55  55  55  55  55  55  55  55  55  55  55  55 224 224 224 224 224 224 224 224 224 224 224 224 224 224 224 224 224 224 224 224 224 224 224 224 224 224 224 224 224 224 224 224 224
  56  56  56  56  56 142 110 110 142 111 112 113 114 115 116 117 118 119 120 121 122 123 124 125 125 125 125 109 172 172 172 172 172 126 126 126 213 213 213 213 213 213 213 213  55  55  55  55  55  55  55  55  55  55  55  55 224 224 224 224 224 224 224 224 224 224 224 224 224 224 224 224 224 224 224 224 224 224 224 224 224 224 224 224 224 224 224 224 224 224
  56  56  56  56  56 142 142 142 142 127 128 129 130 131 132 133 134 135 136 137 138 139 140 141 125 125 125 109 172 172 172 172 172 126 126 126 213 213 213 213 213 213 213 213  55  55  55  55  55  55  55  55  55  55  55 224 224 224 224 224 224 224 224 224 224 224 224 224 224 224 224 224 224 224 224 224 224 224 224 224 224 224 224 224 224 224 224 224 224 224
  56  56  56  56  56 220 142 142 142 173 143 144 145 146 147 148 149 150 151 152 153 154 155 156 125 125 125 109 171 172 172 172 172 213 213 213 213 213 213 213 213 213 213 213  55  55  55  55  55  55  55  55  55  55  55  55 224 224 224 224 224 224 224 224 224 224 224 224 224 224 224 224 224 224 224 224 224 224 224 224 224 224 224 224 224 224 224 224 224 224
  56  56  56  56  56 220 220 142 142 173 173 157 158 159 160 161 162 163 164 165 166 167 168 169 170 125 125 171 171 172 172 172 172 211 199 213 199 199 213 213 213 213 213 213  55  55  55  55  55  55  55  55  55  55  55  55  55 224 224 224 224 224 224 224 224 224 224 224 224 224 224 224 224 224 224 224 224 224 224 224 224 224 224 224 224 224 224 224 224 224
  56  56  56  56 220 220 220 142 220 173 173 174 207 187 175 176 177 178 179 180 181 182 183 184 185 186 198 198 172 172 172 172 172 211 199 199 199 199 199 199 213 213 213  55  55  55  55  55  55  55  55  55  55  55  55 224 224 224 224 224 224 224 224 224 224 224 224 224 224 224 224 224 224 224 224 224 224 224 224 224 224 224 224 224 224 224 224 224 224 224
  56  56  56  56 220 220 220 220 220 173 173 174 207 187 187 187 188 189 190 191 192 193 194 195 196 197 172 198 172 172 172 172 172 211 199 212 199 199 199 199 213 213 213  55  55  55  55  55  55  55  55  55  55  55 224 224 224 224 224 224 224 224 224 224 224 224 224 224 224 224 224 224 224 224 224 224 224 224 224 224 224 224 224 224 224 224 224 224 224 224
  56  56  56  56 220 220 220 220 220 173 173 207 207 214 215 215 188 189 200 201 202 203 204 205 221 206 172 172 172 172 172 172 211 211 212 212 199 199 199 199 213 213 213  55  55  55  55  55  55  55  55  55 225 225 225 224 224 224 224 224 224 224 224 224 224 224 224 224 224 224 224 224 224 224 224 224 224 224 224 224 224 224 224 224 224 224 224 224 224 224
  56  56  56  56  56 220 220 220 220 220 220 207 207 214 214 215 215 215 218 201 218 203 208 205 221 209 209 222 210 210 172 172 211 211 212 212 199 199 199 199 213 213 213  55  55  55  55  55  55  55  55  55 225 225 224 224 224 224 224 224 224 224 224 224 224 224 224 224 224 224 224 224 224 224 224 224 224 224 224 224 224 224 224 224 224 224 224 224 224 224
  56  56  56  56 220 220 220 220 220 220 220 220 214 214 214 215 215 215 218 218 218 218 208 221 221 209 209 222 210 210 216 211 211 217 212 212 213 199 199 199 213 213 213  55  55  55  55  55  55  55  55  55 225 225 225 224 224 224 224 224 224 224 224 224 224 224 224 224 224 224 224 224 224 224 224 224 224 224 224 224 224 224 224 224 224 224 224 224 224 224
  56  56  56  56  56 220 220 220 220 220 220 220 214 214 214 215 215 215 218 218 218 218 219 221 221 222 222 222 222 216 216 223 217 217 212 213 213 213 199 213 213 213 213 213 213  55  55  55  55  55  55  55 225 225 224 224 224 224 224 224 224 224 224 224 224 224 224 224 224 224 224 224 224 224 224 224 224 224 224 224 224 224 224 224 224 224 224 224 224 224
  56  56  56  56  56  56 220 220 220 220 220 220 214 214 214 215 215 215 218 218 218 218 219 221 221 221 222 222 222 216 216 223 217 217 213 213 213 213 213 213 213 213 213 213 213  55  55  55  55  55  55  55 225 225 225 224 224 224 224 224 224 224 224 224 224 224 224 224 224 224 224 224 224 224 224 224 224 224 224 224 224 224 224 224 224 224 224 224 224 224
  56  56  56  56  56  56 220 220 220 220 220 220 220 220 220 220 220 215 218 218 218 218 219 226 221 221 222 222 222 223 223 223 223 223 213 213 213 213 213 213 213 213 213 213 213 213 213  55  55  55  55  55 225 225 225 224 224 224 224 224 224 224 224 224 224 224 224 224 224 224 224 224 224 224 224 224 224 224 224 224 224 224 224 224 224 224 224 224 224 224
  56  56  56  56  56  56  56 220 220 220 220 220 220 220 220 220 220 215 218 218 218 218 219 226 221 221 222 222 222 222 223 223 223 223 213 213 213 213 213 213 213 213 213 213 213 213 213 213  55 225  55 225 225 225 225 224 224 224 224 224 224 224 224 224 224 224 224 224 224 224 224 224 224 224 224 224 224 224 224 224 224 224 224 224 224 224 224 224 224 224
  56  56  56  56  56  56 220 220 220 220 220 220 220 220 220 220 220 218 218 218 219 219 219 226 221 221 226 222 222 222 223 223 223 223 224 213 213 224 224 224 213 213 213 213 213 213 213 225 225 225 225 225 225 225 224 224 224 224 224 224 224 224 224 224 224 224 224 224 224 224 224 224 224 224 224 224 224 224 224 224 224 224 224 224 224 224 224 224 224 224
  56  56  56  56  56 220 220 220 220 220 220 220 220 220 220 220 220 220 218 218 219 219 226 226 226 226 226 222 222 222 223 223 223 223 224 224 213 213 224 224 213 213 213 213 213 213 213 225 225 225 225 225 225 225 224 224 224 224 224 224 224 224 224 224 224 224 224 224 224 224 224 224 224 224 224 224 224 224 224 224 224 224 224 224 224 224 224 224 224 224
  56  56  56  56  56  56 220 220 220 220 220 220 220 220 220 220 220 220 218 218 219 219 226 226 226 226 226 226 226 222 224 224 224 223 224 224 224 224 224 224 213 213 213 213 213 213 213 225 225 225 225 225 225 225 225 224 224 224 224 224 224 224 224 224 224 224 224 224 224 224 224 224 224 224 224 224 224 224 224 224 224 224 224 224 224 224 224 224 224 224
  56  56  56  56  56  56  56 220 220 220 220 220 220 220 220 220 220 220 220 220 226 226 226 226 226 226 226 226 226 224 224 224 224 224 224 224 224 224 224 224 224 224 213 224 213 225 225 225 225 225 225 225 225 225 224 224 224 224 224 224 224 224 224 224 224 224 224 224 224 224 224 224 224 224 224 224 224 224 224 224 224 224 224 224 224 224 224 224 224 224
  56  56  56  56  56  56  56  56 220 220 220 220 220 220 220 220 220 220 220 220 226 226 226 226 226 226 226 226 226 224 224 224 224 224 224 224 224 224 224 224 224 224 224 224 224 225 225 225 225 225 225 225 224 224 224 224 224 224 224 224 224 224 224 224 224 224 224 224 224 224 224 224 224 224 224 224 224 224 224 224 224 224 224 224 224 224 224 224 224 224
  56  56  56  56  56  56  56  56 220 220 220 220 220 220 220 220 220 220 220 220 220 226 226 226 226 226 226 226 226 224 224 224 224 224 224 224 224 224 224 224 224 224 224 224 224 224 224 225 225 225 225 225 224 224 224 224 224 224 224 224 224 224 224 224 224 224 224 224 224 224 224 224 224 224 224 224 224 224 224 224 224 224 224 224 224 224 224 224 224 224
  56  56  56  56  56  56  56 220 220 220 220 220 220 220 220 220 220 220 220 220 226 226 226 226 226 226 226 226 226 224 224 224 224 224 224 224 224 224 224 224 224 224 224 224 224 224 224 225 225 225 225 225 224 224 224 224 224 224 224 224 224 224 224 224 224 224 224 224 224 224 224 224 224 224 224 224 224 224 224 224 224 224 224 224 224 224 224 224 224 224
  56  56  56  56  56  56 220 220 220 220 220 220 220 220 220 220 220 220 226 226 226 226 226 226 226 226 224 224 224 224 224 224 224 224 224 224 224 224 224 224 224 224 224 224 224 224 224 225 225 225 224 224 224 224 224 224 224 224 224 224 224 224 224 224 224 224 224 224 224 224 224 224 224 224 224 224 224 224 224 224 224 224 224 224 224 224 224 224 224 224
  56  56  56  56  56  56  56 220 220 220 220 220 220 220 220 220 220 226 226 226 226 226 226 226 226 224 224 224 224 224 224 224 224 224 224 224 224 224 224 224 224 224 224 224 224 224 224 225 225 225 224 224 224 224 224 224 224 224 224 224 224 224 224 224 224 224 224 224 224 224 224 224 224 224 224 224 224 224 224 224 224 224 224 224 224 224 224 224 224 224
  56  56  56  56  56  56  56  56 220 220 220 220 220 220 220 220 220 226 226 226 226 226 224 224 224 224 224 224 224 224 224 224 224 224 224 224 224 224 224 224 224 224 224 224 224 224 224 225 225 225 224 224 224 224 224 224 224 224 224 224 224 224 224 224 224 224 224 224 224 224 224 224 224 224 224 224 224 224 224 224 224 224 224 224 224 224 224 224 224 224
  56  56  56  56  56  56  56  56  56 220 220 220 220 220 220 220 220 226 226 224 224 224 224 224 224 224 224 224 224 224 224 224 224 224 224 224 224 224 224 224 224 224 224 224 224 224 224 224 225 225 224 224 224 224 224 224 224 224 224 224 224 224 224 224 224 224 224 224 224 224 224 224 224 224 224 224 224 224 224 224 224 224 224 224 224 224 224 224 224 224
  56  56  56  56  56  56  56  56  56 220 220 220 220 220 220 220 220 226 224 224 224 224 224 224 224 224 224 224 224 224 224 224 224 224 224 224 224 224 224 224 224 224 224 224 224 224 224 224 224 224 224 224 224 224 224 224 224 224 224 224 224 224 224 224 224 224 224 224 224 224 224 224 224 224 224 224 224 224 224 224 224 224 224 224 224 224 224 224 224 224
  56  56  56  56  56  56  56  56  56  56 220 220 220 220 220 220 220 224 224 224 224 224 224 224 224 224 224 224 224 224 224 224 224 224 224 224 224 224 224 224 224 224 224 224 224 224 224 224 224 224 224 224 224 224 224 224 224 224 224 224 224 224 224 224 224 224 224 224 224 224 224 224 224 224 224 224 224 224 224 224 224 224 224 224 224 224 224 224 224 224
  56  56  56  56  56  56  56  56  56  56  56 220 220 220 220 220 224 224 224 224 224 224 224 224 224 224 224 224 224 224 224 224 224 224 224 224 224 224 224 224 224 224 224 224 224 224 224 224 224 224 224 224 224 224 224 224 224 224 224 224 224 224 224 224 224 224 224 224 224 224 224 224 224 224 224 224 224 224 224 224 224 224 224 224 224 224 224 224 224 224
  56  56  56  56  56  56  56  56  56  56  56  56 220 220 220 220 224 224 224 224 224 224 224 224 224 224 224 224 224 224 224 224 224 224 224 224 224 224 224 224 224 224 224 224 224 224 224 224 224 224 224 224 224 224 224 224 224 224 224 224 224 224 224 224 224 224 224 224 224 224 224 224 224 224 224 224 224 224 224 224 224 224 224 224 224 224 224 224 224 224
  56  56  56  56  56  56  56  56  56  56  56  56  56 220 220  56  56 224 224 224 224 224 224 224 224 224 224 224 224 224 224 224 224 224 224 224 224 224 224 224 224 224 224 224 224 224 224 224 224 224 224 224 224 224 224 224 224 224 224 224 224 224 224 224 224 224 224 224 224 224 224 224 224 224 224 224 224 224 224 224 224 224 224 224 224 224 224 224 224 224
  56  56  56  56  56  56  56  56  56  56  56  56  56  56  56  56  56 224 224 224 224 224 224 224 224 224 224 224 224 224 224 224 224 224 224 224 224 224 224 224 224 224 224 224 224 224 224 224 224 224 224 224 224 224 224 224 224 224 224 224 224 224 224 224 224 224 224 224 224 224 224 224 224 224 224 224 224 224 224 224 224 224 224 224 224 224 224 224 224 224
  56  56  56  56  56  56  56  56  56  56  56  56  56  56  56  56 224 224 224 224 224 224 224 224 224 224 224 224 224 224 224 224 224 224 224 224 224 224 224 224 224 224 224 224 224 224 224 224 224 224 224 224 224 224 224 224 224 224 224 224 224 224 224 224 224 224 224 224 224 224 224 224 224 224 224 224 224 224 224 224 224 224 224 224 224 224 224 224 224 224
  56  56  56  56  56  56  56  56  56  56  56  56  56  56  56 224 224 224 224 224 224 224 224 224 224 224 224 224 224 224 224 224 224 224 224 224 224 224 224 224 224 224 224 224 224 224 224 224 224 224 224 224 224 224 224 224 224 224 224 224 224 224 224 224 224 224 224 224 224 224 224 224 224 224 224 224 224 224 224 224 224 224 224 224 224 224 224 224 224 224
  56  56  56  56  56  56  56  56  56  56  56  56  56  56 224 224 224 224 224 224 224 224 224 224 224 224 224 224 224 224 224 224 224 224 224 224 224 224 224 224 224 224 224 224 224 224 224 224 224 224 224 224 224 224 224 224 224 224 224 224 224 224 224 224 224 224 224 224 224 224 224 224 224 224 224 224 224 224 224 224 224 224 224 224 224 224 224 224 224 224
  56  56  56  56  56  56  56  56  56  56  56  56  56 224 224 224 224 224 224 224 224 224 224 224 224 224 224 224 224 224 224 224 224 224 224 224 224 224 224 224 224 224 224 224 224 224 224 224 224 224 224 224 224 224 224 224 224 224 224 224 224 224 224 224 224 224 224 224 224 224 224 224 224 224 224 224 224 224 224 224 224 224 224 224 224 224 224 224 224 224
  56  56  56  56  56  56  56  56  56  56  56  56 224 224 224 224 224 224 224 224 224 224 224 224 224 224 224 224 224 224 224 224 224 224 224 224 224 224 224 224 224 224 224 224 224 224 224 224 224 224 224 224 224 224 224 224 224 224 224 224 224 224 224 224 224 224 224 224 224 224 224 224 224 224 224 224 224 224 224 224 224 224 224 224 224 224 224 224 224 224
  56  56  56  56  56  56  56  56  56  56  56  56  56 224 224 224 224 224 224 224 224 224 224 224 224 224 224 224 224 224 224 224 224 224 224 224 224 224 224 224 224 224 224 224 224 224 224 224 224 224 224 224 224 224 224 224 224 224 224 224 224 224 224 224 224 224 224 224 224 224 224 224 224 224 224 224 224 224 224 224 224 224 224 224 224 224 224 224 224 224
  56  56  56  56  56  56  56  56  56  56  56  56  56  56 224 224 224 224 224 224 224 224 224 224 224 224 224 224 224 224 224 224 224 224 224 224 224 224 224 224 224 224 224 224 224 224 224 224 224 224 224 224 224 224 224 224 224 224 224 224 224 224 224 224 224 224 224 224 224 224 224 224 224 224 224 224 224 224 224 224 224 224 224 224 224 224 224 224 224 224
  56  56  56  56  56  56  56  56  56  56  56  56  56  56  56 224 224 224 224 224 224 224 224 224 224 224 224 224 224 224 224 224 224 224 224 224 224 224 224 224 224 224 224 224 224 224 224 224 224 224 224 224 224 224 224 224 224 224 224 224 224 224 224 224 224 224 224 224 224 224 224 224 224 224 224 224 224 224 224 224 224 224 224 224 224 224 224 224 224 224
