  84  84  84   3   4   5   1   2  10  10  10  11  12  13  15  15  17  17  17  20  20  21  21  42  43  44  47  47  47  47  48  48  48  49  49  82  82  82  82  82  82  82  83  83  83  83  83  83  83  83  83 400 400 400 400 400 400 400 400 400 400 400 400 400 400 400 400 400 400 400 400 400 400 400 400 400 400 400 400 400 400 400 400 400 400 400 400 400 400 400
  84  84  84   3   4   5   6   7   8   9  10  11  12  13  14  15  16  17  18  19  20  40  21  42  43  44  47  47  47  47  48  48  48  49  49  82  82  82  82  82  82  83  83  83  83  83  83  83  83  83  83  83 400 400 400 400 400 400 400 400 400 400 400 400 400 400 400 400 400 400 400 400 400 400 400 400 400 400 400 400 400 400 400 400 400 400 400 400 400 400
  84  84  84  22  23  24  25  26  27  28  29  30  31  32  33  34  35  36  37  38  39  40  41  42  43  44  45  74  46  47  77  48  80  80  49  82  82  82  82  82  83  83  83  83  83  83  83  83  83  83  83 400 400 400 400 400 400 400 400 400 400 400 400 400 400 400 400 400 400 400 400 400 400 400 400 400 400 400 400 400 400 400 400 400 400 400 400 400 400 400
  84  84  84  50  51  52  53  54  55  56  57  58  59  60  61  62  63  64  65  66  67  68  69  70  71  72  73  74  75  76  77  78  79  80  81  82  82  82 114  82  83  83  83  83  83  83  83  83  83  83  83 400 400 212 400 400 400 400 400 400 400 400 400 400 400 400 400 400 400 400 400 400 400 400 400 400 400 400 400 400 400 400 400 400 400 400 400 400 400 400
  84  84  84  50  85  86  87  88  89  90  91  92  93  94  95  96  97  98  99 100 101 102 103 104 105 106 107 108 109  76 110 111 112 113 188  82  82  82 114 114 115 115 115 115 115  83  83  83  83 212 212 400 212 212 212 400 400 400 400 400 400 400 400 400 400 400 400 400 400 400 400 400 400 400 400 400 400 400 400 400 400 400 400 400 400 400 400 400 400 400
  84  84  84  50 116 116 116 117 118 119 120 121 122 123 124 125 126 127 128 129 130 131 132 133 134 135 136 137 138 139 140 258 188 188 188 188  82  82 114 114 115 115 115 115 115  83  83  83  83 212 212 212 212 212 212 212 400 400 400 400 400 400 400 400 400 400 400 400 400 400 400 400 400 400 400 400 400 400 400 400 400 400 400 400 400 400 400 400 400 400
  84  84  84  50  50 141 142 143 144 145 146 147 148 149 150 151 152 153 154 155 156 157 158 159 160 161 162 163 164 165 258 258 166 188 188 188 114 114 114 114 115 115 115 115  83  83  83 212 212 212 212 212 212 212 212 212 400 400 400 400 400 400 416 400 400 400 400 400 400 400 400 400 400 400 400 400 400 400 400 400 400 400 400 400 400 400 400 400 400 400
 438  84  84  84  84 213 167 167 168 169 170 171 172 173 174 175 176 177 178 179 180 181 182 183 184 185 186 163 187 258 258 258 166 188 188 188 114 235 114 114 115 115 115 115  83  83  83 212 212 212 212 212 212 212 212 400 400 400 400 400 400 400 416 416 400 400 400 400 400 400 400 400 400 400 400 400 400 400 400 400 400 400 400 400 400 400 400 400 400 400
 438 438  84  84  84 213 213 213 189 190 191 192 193 194 195 196 197 198 199 200 201 202 203 204 205 206 207 208 209 210 211 258 258 188 188 188 235 235 114 114 115 115 115 115  83  83 212 212 212 212 212 212 212 212 400 400 400 400 400 400 400 400 400 416 416 400 400 400 400 400 400 400 400 400 400 400 400 400 400 400 400 400 400 400 400 400 400 400 400 400
 438 438  84  84  84 236 213 213 213 214 215 216 217 218 219 220 221 222 223 224 225 226 227 228 229 230 231 232 233 210 282 234 258 260 260 260 235 235 348 348 348 115 115 115  83  83  83 212 212 212 212 212 212 212 212 400 400 400 400 400 400 400 430 430 416 416 400 400 400 400 400 400 400 400 400 400 400 400 400 400 400 400 400 400 400 400 400 400 400 400
 438 438  84  84  84 236 236 213 237 238 239 240 241 242 243 244 245 246 247 248 249 250 251 252 253 254 255 256 257 281 282 258 258 283 259 260 305 305 348 348 348 348 348 115  83  83  83 212 212 212 212 212 212 212 212 212 400 400 400 400 400 430 430 430 430 416 416 400 400 400 400 400 400 400 400 400 400 400 400 400 400 400 400 400 400 400 400 400 400 400
 438 438 438  84 236 236 236 213 236 261 262 263 264 265 266 267 268 269 270 271 272 273 274 275 276 277 278 279 280 281 282 258 258 283 259 305 305 305 305 305 348 348 348  83  83  83  83 212 212 212 212 212 212 212 212 430 430 400 400 400 430 430 430 430 430 430 416 416 400 400 400 400 400 400 400 400 400 400 400 400 400 400 400 400 400 400 400 400 400 400
 438 438 438 438 438 236 236 236 236 262 262 284 285 286 287 288 289 290 291 292 293 294 295 296 297 298 299 300 301 302 303 258 304 345 259 346 305 305 305 305 348 348 348  83  83  83  83  83 212 212 212 212 212 212 430 430 430 430 430 430 430 430 430 430 430 430 430 416 416 400 400 400 400 400 400 400 400 400 400 400 400 400 400 400 400 400 400 400 400 400
 438 438 438 438 438 236 236 236 236 262 262 326 306 307 308 309 310 311 312 313 314 315 316 317 318 319 320 321 322 323 324 258 325 345 346 346 305 305 305 305 348 348 348  83  83  83  83  83 349 212 349 212 415 415 415 430 430 430 430 430 430 430 430 430 430 430 416 416 416 416 400 400 400 400 400 400 400 400 400 400 400 400 400 400 400 400 400 400 400 400
 438 438 438 438 438 438 236 236 236 386 386 326 326 307 327 328 329 330 331 332 333 334 335 336 337 338 339 340 341 342 343 344 345 345 346 346 305 347 347 305 348 348 348  83  83  83  83  83 349 349 349 212 415 415 430 430 430 430 430 430 430 430 430 430 430 416 416 416 416 416 416 400 400 400 400 400 400 400 400 400 400 400 400 400 400 400 400 400 400 400
 438 438 438 438 438 236 236 417 417 386 386 386 366 366 366 350 351 368 352 353 354 355 335 356 357 358 359 360 361 362 363 364 365 383 346 346 348 305 305 305 348 348 348  83  83  83  83  83 349 349 349 349 415 415 415 430 430 430 430 430 430 430 430 430 416 416 416 416 416 416 416 400 400 400 400 400 400 400 400 400 400 400 400 400 400 400 400 400 400 400
 438 438 438 438 438 438 236 417 417 417 386 386 366 366 366 368 367 368 369 370 371 372 373 374 375 376 377 360 378 379 380 381 382 383 384 385 348 348 305 348 348 348 348 348 348 349  83  83 349 349 349 349 415 415 430 430 430 430 430 430 430 430 430 416 416 416 416 416 416 416 416 416 400 400 400 400 400 400 400 400 400 400 400 400 400 400 400 400 400 400
 438 438 438 438 438 438 438 417 417 386 386 386 366 366 366 368 368 368 369 387 388 389 390 391 392 393 394 395 378 396 380 397 398 383 411 399 348 348 348 348 348 348 348 348 348 349 349 349 349 349 349 349 415 415 415 430 430 430 430 430 430 416 416 416 416 416 416 416 416 416 416 416 400 400 400 400 400 400 400 400 400 400 400 400 400 400 400 400 400 400
 438 438 438 438 438 438 417 417 417 417 386 386 417 417 417 417 418 368 401 401 402 402 413 403 404 405 406 407 422 408 414 409 410 423 411 411 348 348 348 348 348 348 348 348 425 425 425 349 349 349 349 349 415 415 415 430 430 430 430 430 430 430 416 416 416 416 416 416 416 416 416 416 400 400 400 400 400 400 400 400 400 400 400 400 400 400 400 400 400 400
 438 438 438 438 438 438 438 417 417 386 386 417 417 417 417 417 418 368 412 412 402 402 413 403 420 420 422 422 422 422 414 423 423 423 411 411 429 348 348 348 424 424 424 425 425 425 425 425 349 434 349 434 415 415 415 430 430 430 430 430 430 416 416 416 416 416 416 416 400 416 416 400 400 400 400 400 400 416 400 400 400 400 400 400 400 400 400 400 400 400
 438 438 438 438 438 438 417 417 417 417 386 417 417 417 417 417 418 412 412 412 413 413 413 426 419 420 421 422 422 422 423 423 423 423 428 411 429 433 433 433 424 424 424 425 425 425 425 434 434 434 434 434 415 415 430 430 430 430 430 430 416 416 416 416 416 416 416 400 400 400 400 400 400 400 400 400 416 416 416 400 400 400 400 400 400 400 400 400 400 400
 438 438 438 438 438 417 417 417 417 417 417 417 417 417 417 417 417 417 412 412 413 413 435 426 426 435 427 422 422 422 423 423 423 423 428 428 429 429 433 433 424 424 424 425 425 425 425 434 434 434 415 415 415 415 415 430 416 416 430 416 416 416 416 416 416 416 416 416 400 416 416 400 400 400 400 400 400 416 416 416 400 400 400 400 400 400 400 400 400 400
 438 438 438 438 438 438 417 417 417 417 417 417 417 417 417 417 417 417 412 412 413 413 435 435 435 435 435 435 435 422 436 431 431 423 432 433 433 433 433 433 424 424 424 425 425 425 425 434 434 434 415 415 415 415 415 430 416 416 416 416 416 416 416 416 416 416 416 416 416 416 416 416 400 400 400 400 400 400 416 416 416 400 400 400 400 400 400 400 400 400
 438 438 438 438 438 438 438 417 417 417 417 417 417 417 417 417 417 417 417 417 435 435 435 435 435 435 435 435 435 436 436 431 431 432 432 433 433 433 433 433 437 437 424 433 425 434 434 434 434 434 434 434 415 415 430 430 430 416 416 416 416 416 416 416 416 416 416 416 416 416 416 416 400 400 400 400 400 400 400 416 416 400 400 400 400 400 400 400 400 400
 438 438 438 438 438 438 438 438 417 417 417 417 417 417 417 417 417 417 417 417 435 438 438 435 435 435 435 435 435 436 436 431 431 431 432 433 433 433 433 433 437 437 437 433 433 434 434 434 434 434 434 434 430 430 430 430 430 430 416 416 416 416 416 416 416 416 416 416 416 416 416 416 416 400 400 400 400 400 416 416 400 400 400 400 400 400 400 400 400 400
 438 438 438 438 438 438 438 438 417 417 417 417 417 417 417 417 417 417 417 417 417 438 438 438 435 435 435 435 435 436 436 433 433 431 433 433 433 433 433 437 437 437 437 433 433 433 433 434 434 434 434 434 439 439 430 430 430 416 416 416 416 416 416 416 416 416 416 416 416 416 416 416 416 416 400 400 400 416 416 400 400 400 400 400 400 400 400 400 400 400
 438 438 438 438 438 438 438 417 417 417 417 417 417 417 417 417 417 417 417 417 438 438 438 435 435 435 435 435 435 440 440 433 433 433 433 433 433 433 433 437 437 433 433 433 433 433 433 434 434 434 434 434 439 439 430 430 430 430 416 416 430 416 416 416 416 416 416 416 416 416 416 416 416 416 416 400 416 416 400 400 400 400 400 400 400 400 400 400 400 400
 438 438 438 438 438 438 417 417 417 417 417 417 417 417 417 417 417 417 438 438 438 438 435 435 435 435 440 440 440 440 440 440 433 433 433 433 433 433 433 433 437 433 433 433 433 433 433 434 434 434 439 439 439 439 439 430 430 430 416 430 430 430 416 416 416 416 416 416 416 416 416 416 416 416 416 416 416 400 400 400 400 400 400 400 400 400 400 400 400 400
 438 438 438 438 438 438 438 417 417 417 417 417 417 417 417 417 417 438 438 438 438 435 435 435 435 440 440 440 440 440 440 440 433 433 433 433 433 433 433 433 433 433 433 433 433 433 433 434 434 434 439 439 439 439 439 430 430 430 430 430 430 430 430 416 416 416 416 416 416 416 416 416 416 416 416 416 400 400 400 400 400 400 400 400 400 400 400 400 400 400
 438 438 438 438 438 438 438 438 417 417 417 417 417 417 417 417 417 438 438 438 438 435 440 440 440 440 440 440 440 440 440 440 433 433 433 433 433 433 433 433 433 433 433 433 433 433 433 434 434 434 439 439 439 439 439 430 430 430 430 430 430 430 430 416 416 416 416 416 416 416 416 416 416 416 416 400 400 400 400 400 400 400 400 400 400 400 400 400 400 400
 438 438 438 438 438 438 438 438 438 417 417 417 417 417 417 417 417 438 438 438 440 440 440 440 440 440 440 440 440 440 440 440 433 433 433 433 433 433 433 433 433 433 433 433 433 433 433 433 434 434 433 433 433 430 439 430 430 430 430 430 430 430 416 416 416 416 416 416 416 416 416 416 416 416 416 416 400 400 400 400 400 400 400 400 400 400 400 400 400 400
 438 438 438 438 438 438 438 438 438 417 417 417 417 417 417 417 417 438 438 440 440 440 440 440 440 440 440 440 440 440 440 440 433 433 433 433 433 433 433 433 433 433 433 433 433 433 433 433 433 433 433 433 433 430 430 430 430 430 430 430 416 416 416 416 416 416 416 416 416 416 416 416 416 416 416 416 400 400 400 400 400 400 400 400 400 400 400 400 400 400
 438 438 438 438 438 438 438 438 438 438 417 417 417 417 417 438 438 438 440 440 440 440 440 440 440 440 440 440 440 440 440 440 433 433 433 433 433 433 433 433 433 433 433 433 433 433 433 433 433 433 433 433 416 416 416 430 430 430 430 416 416 416 416 416 416 416 416 416 416 416 416 416 416 416 416 400 400 400 400 400 400 400 400 400 400 400 400 400 400 400
 438 438 438 438 438 438 438 438 438 438 438 417 417 417 417 417 438 440 440 440 440 440 440 440 440 440 440 440 440 440 440 440 440 440 433 433 433 433 440 433 433 433 433 433 433 433 433 433 433 433 433 416 416 416 416 416 416 430 416 416 416 416 416 416 416 416 416 416 416 416 416 416 416 416 400 400 400 400 400 400 400 400 400 400 400 400 400 400 400 400
 438 438 438 438 438 438 438 438 438 438 438 438 417 417 417 417 438 440 440 440 440 440 440 440 440 440 440 440 440 440 440 440 440 440 440 433 433 440 440 433 433 433 433 433 433 433 433 433 433 433 433 416 416 416 416 416 416 430 416 416 416 416 416 416 416 416 416 416 416 416 416 416 416 416 416 400 400 400 400 400 400 400 400 400 400 400 400 400 400 400
 438 438 438 438 438 438 438 438 438 438 438 438 438 417 417 438 438 438 440 440 440 440 440 440 440 440 440 440 440 440 440 440 440 440 440 440 440 440 433 433 433 433 433 433 433 433 433 433 433 433 433 433 416 416 416 416 430 430 430 416 416 416 416 416 416 416 416 416 416 416 416 416 416 416 416 416 400 400 400 400 400 400 400 400 400 400 400 400 400 400
 438 438 438 438 438 438 438 438 438 438 438 438 438 438 438 438 438 438 440 440 440 440 440 440 440 440 440 440 440 440 440 440 440 440 440 440 433 433 433 433 433 433 433 433 433 433 433 433 433 433 433 433 433 416 416 416 416 430 416 416 416 416 416 416 416 416 416 416 416 416 416 416 416 416 416 416 416 400 400 400 400 400 400 400 400 400 400 400 400 400
 438 438 438 438 438 438 438 438 438 438 438 438 438 438 438 438 438 440 440 440 440 440 440 440 440 440 440 440 440 440 440 440 440 440 440 433 433 433 433 433 433 433 433 433 433 433 433 433 433 433 433 433 433 433 416 416 416 416 416 416 416 416 416 416 416 416 416 416 416 416 416 416 416 416 416 416 416 416 400 400 400 416 416 400 400 400 400 400 400 400
 438 438 438 438 438 438 438 438 438 438 438 438 438 438 438 438 440 440 440 440 440 440 440 440 440 440 440 440 440 440 440 440 440 440 433 433 433 433 433 433 433 433 433 433 433 433 433 433 433 433 433 433 433 433 433 416 416 416 416 416 416 416 416 416 416 416 416 416 416 416 416 416 416 416 416 416 416 416 416 400 416 416 416 416 400 400 400 400 400 416
 438 438 438 438 438 438 438 438 438 438 438 438 438 438 438 440 440 440 440 440 440 440 440 440 440 440 440 440 440 440 440 440 440 440 440 433 433 433 433 433 433 433 433 416 433 433 433 433 433 433 433 433 433 433 416 416 416 416 416 416 416 416 416 416 416 416 416 416 416 416 416 416 416 416 416 416 416 416 416 416 416 416 416 416 416 400 400 400 416 416
 438 438 438 438 438 438 438 438 438 438 438 438 438 438 440 440 440 440 440 440 440 440 440 440 440 440 440 440 440 440 440 440 440 440 440 440 433 433 433 433 433 433 433 416 416 433 433 433 433 433 433 433 433 416 416 416 416 416 416 416 416 416 416 416 416 416 416 416 416 416 416 416 416 416 416 416 416 416 416 416 416 416 416 416 416 416 400 416 416 416
 438 438 438 438 438 438 438 438 438 438 438 438 438 440 440 440 440 440 440 440 440 440 440 440 440 440 440 440 440 440 440 440 440 440 440 440 440 440 433 433 433 433 433 433 416 416 416 433 433 433 433 433 416 416 416 416 416 416 416 416 416 416 416 416 416 416 416 416 416 416 416 416 416 416 416 416 416 416 416 416 416 416 416 416 416 416 416 416 416 416
 438 438 438 438 438 438 438 438 438 438 438 438 438 438 440 440 440 440 440 440 440 440 440 440 440 440 440 440 440 440 440 440 440 440 440 440 440 440 433 433 433 433 433 433 433 416 416 416 433 433 433 416 416 416 416 416 416 416 416 416 416 416 416 416 416 416 416 416 416 416 416 416 416 416 416 416 416 416 416 416 416 416 416 416 416 416 416 416 416 416
 438 438 438 438 438 438 438 438 438 438 438 438 438 438 438 440 440 440 440 440 440 440 440 440 440 440 440 440 440 440 440 440 440 440 440 440 440 433 433 433 433 433 433 433 433 433 416 416 416 433 416 416 416 416 416 416 416 416 416 416 416 416 416 416 416 416 416 416 416 416 416 416 416 416 416 416 416 416 416 416 416 416 416 416 416 416 416 416 416 416
 438 438 438 438 438 438 438 438 438 438 438 438 438 438 438 438 440 440 440 440 440 440 440 440 440 440 440 440 440 440 440 440 440 440 440 440 440 440 433 433 433 433 433 433 433 416 416 416 416 416 416 416 416 416 416 416 416 416 416 416 416 416 416 416 416 416 416 416 416 416 416 416 416 416 416 416 416 416 416 416 416 416 416 416 416 416 416 416 416 416
